F1,F2,F3,F4,F5,F6,F7,F8,F9,F10,F11,F12,F13,F14,F15,F16,F17,F18,F19,F20,F21,F22,F23,F24,label
-37,15,67,82,89,107,149,84,49,-5,2,-37,60,-2,23,12,197,81,148,23,194,224,226,160,ENTRY
-11,19,36,55,44,67,76,64,2,17,6,-11,12,6,18,-9,52,35,56,1,23,47,56,41,ENTRY
-31,22,31,53,55,44,67,76,-11,-36,-34,-31,-9,-19,-28,-42,1,-30,-16,-40,41,-1,22,-30,ENTRY
82,85,1,86,37,37,52,54,-11,46,-3,82,-43,37,-12,71,3,40,6,39,-41,35,3,85,ENTRY
-13,8,15,23,38,33,42,45,-5,-15,0,-13,4,-9,1,-18,18,-4,15,-9,18,-6,16,5,ENTRY
31,48,46,94,98,171,103,216,-4,16,20,31,-90,-18,59,27,-61,-43,-34,-59,-219,-181,-59,-30,ENTRY
99,106,45,151,94,98,171,103,31,98,41,99,27,114,61,130,-59,80,100,126,-30,55,7,40,ENTRY
199,216,6,222,91,93,162,123,-24,158,27,199,-14,156,27,175,-118,87,27,185,-86,25,-74,81,ENTRY
-26,49,27,76,69,132,218,222,3,-55,-62,-26,29,-93,-37,-23,207,-6,136,3,406,202,348,181,ENTRY
3,13,56,69,132,218,222,91,26,-38,25,3,204,49,198,29,403,257,410,207,379,415,437,406,ENTRY
-29,7,61,68,48,83,135,46,-8,-5,-25,-29,62,14,29,-37,178,88,155,33,141,169,147,149,ENTRY
-94,59,99,158,67,77,37,67,-9,-16,-107,-94,14,-22,-103,-103,32,19,-102,-80,12,13,-78,-62,ENTRY
62,76,3,79,70,67,65,115,-4,35,26,62,-5,18,6,58,48,49,35,57,-31,7,43,110,ENTRY
-105,2,120,122,189,45,67,66,145,-29,38,-105,149,148,71,40,186,154,99,44,239,201,145,81,ENTRY
22,24,5,29,79,14,50,19,41,-6,44,22,35,55,40,63,-9,18,39,57,-24,-1,-11,13,ENTRY
-114,8,116,124,58,68,66,63,16,0,-66,-114,29,-25,-81,-98,45,-12,-70,-85,87,42,-19,-69,ENTRY
17,33,18,51,68,46,90,83,36,27,44,17,7,42,37,53,-53,-20,19,24,-87,-85,-53,-36,ENTRY
36,44,4,48,35,57,63,56,5,16,3,36,-16,-6,3,41,-36,-32,-17,20,-55,-36,-28,0,ENTRY
12,26,3,29,46,40,30,34,-4,6,23,12,-2,-2,9,8,-12,-10,-9,10,-1,1,6,0,ENTRY
-27,9,53,62,63,54,76,79,28,0,1,-27,-7,15,7,1,33,13,27,-34,60,45,62,6,ENTRY
15,27,5,32,62,63,54,76,-27,-33,-3,15,1,-33,-2,-12,-34,-18,4,16,6,-20,24,-19,ENTRY
143,170,5,175,117,113,117,73,5,125,67,143,-62,54,-8,148,-83,65,7,81,-99,33,-69,60,ENTRY
-13,10,55,65,60,67,83,75,-24,-16,-21,-13,33,12,14,-37,49,53,71,20,48,71,81,36,ENTRY
-13,15,15,30,59,32,31,40,42,-8,21,-13,71,41,43,29,91,69,70,58,69,66,76,78,ENTRY
25,34,3,37,26,63,23,22,-10,18,7,25,-65,-38,-12,15,-80,-55,-69,-40,-80,-60,-75,-55,ENTRY
20,24,6,30,18,20,51,22,10,23,11,20,-6,20,10,30,23,8,29,14,5,29,21,43,ENTRY
-3,17,6,23,73,40,58,47,58,-7,43,-3,80,56,73,55,61,41,76,77,83,62,86,58,ENTRY
-34,13,34,47,23,73,40,58,-3,-6,-30,-34,55,-13,13,-37,77,50,43,21,58,35,46,43,ENTRY
56,59,4,63,35,27,31,37,24,58,30,56,-2,58,22,80,-32,27,-5,54,-53,6,-20,24,ENTRY
-201,47,201,248,126,112,36,71,91,-19,-141,-201,150,38,-98,-110,155,146,-66,-51,185,134,-43,-46,ENTRY
114,130,10,140,91,178,80,130,-21,50,1,114,-92,-1,37,93,-74,-6,-66,22,-101,-46,-56,40,ENTRY
-100,4,100,104,100,91,106,46,65,-19,-23,-100,100,52,39,-35,158,90,92,0,176,139,81,58,ENTRY
-60,4,92,96,78,83,104,63,3,-27,-45,-60,39,2,-11,-57,76,10,18,-21,100,77,44,16,ENTRY
-8,77,9,86,30,60,66,67,-6,-11,-67,-8,23,-10,-36,-14,7,4,-16,15,61,2,-17,-1,ENTRY
-50,9,67,76,86,30,60,66,-8,8,18,-50,-14,-3,-49,-58,15,-2,-18,-64,-1,12,2,-35,ENTRY
3,9,24,33,58,96,79,55,38,24,49,3,-47,-26,37,41,-97,-79,-33,-44,-109,-122,-100,-94,ENTRY
5,13,20,33,41,39,60,88,-2,-11,-3,5,-13,-4,2,3,30,0,27,-8,89,28,83,35,ENTRY
-29,0,50,50,33,41,39,60,5,1,-16,-29,3,-10,-19,-24,-8,-3,-14,-26,35,1,11,-37,ENTRY
101,101,9,110,62,113,62,82,-38,71,23,101,-115,-16,-13,63,-118,-60,-108,-14,-156,-58,-86,-17,ENTRY
-61,26,63,89,55,61,107,126,-31,-44,-78,-61,3,-44,-72,-92,31,-6,12,-58,134,30,67,-30,ENTRY
33,47,11,58,28,27,15,13,-5,38,8,33,-24,16,-15,28,-20,16,-27,9,-30,12,-33,13,ENTRY
-97,107,123,230,159,79,191,61,-43,-96,-167,-97,-81,-61,-212,-140,73,-60,-99,-178,117,88,-81,-24,ENTRY
29,71,1,72,74,133,134,109,43,-1,1,29,19,34,95,72,-64,-38,24,48,-62,-118,-81,-35,ENTRY
-54,14,98,112,133,102,79,110,105,21,42,-54,20,59,49,51,43,18,-15,-34,-41,-1,-3,-11,ENTRY
40,76,23,99,49,56,39,40,-18,23,-27,40,-60,-1,-44,22,-61,-25,-85,-20,-67,-31,-90,-21,ENTRY
-81,14,104,118,108,84,54,124,72,-4,-14,-81,26,37,3,-9,13,36,-28,-55,124,33,39,-68,ENTRY
34,49,17,66,192,157,117,78,122,39,165,34,-4,33,124,156,-73,-52,-1,30,-141,-93,-81,-39,ENTRY
34,35,9,44,84,71,37,28,-69,-32,8,34,-92,-64,-37,-35,-112,-69,-76,-58,-118,-94,-110,-78,ENTRY
-76,4,76,80,24,42,63,27,1,-14,-70,-76,24,-18,-56,-75,56,3,-14,-52,59,50,-3,-20,ENTRY
20,44,15,59,86,85,114,37,-38,-13,14,20,-22,-56,-30,-18,-90,-55,0,-2,-82,-75,-97,-70,ENTRY
-77,16,85,101,140,40,82,87,118,-11,28,-77,128,113,52,41,127,78,59,51,177,114,100,50,ENTRY
48,48,12,60,77,69,60,77,-21,-17,0,48,-57,-28,-19,27,-112,-53,-53,-9,-174,-123,-106,-64,ENTRY
-41,14,100,114,89,64,90,60,-42,-1,-26,-41,4,17,-33,-83,81,60,36,-37,129,128,74,40,ENTRY
123,123,13,136,137,84,83,114,-52,34,35,123,-44,33,-19,71,-107,12,-41,79,-148,-71,-93,16,ENTRY
76,84,6,90,101,117,43,37,84,67,78,76,-19,62,89,160,-2,44,-3,57,-15,45,-8,74,ENTRY
96,98,1,99,112,72,44,57,-85,0,13,96,-45,9,-18,11,-48,33,-22,51,-71,19,-23,48,ENTRY
-29,21,30,51,30,22,36,46,19,-6,-27,-29,38,20,-9,-10,39,23,8,9,65,24,19,10,ENTRY
16,17,1,18,21,9,17,20,2,0,3,16,10,18,9,18,5,19,18,26,9,13,15,21,ENTRY
-28,11,42,53,27,38,44,29,9,4,-22,-28,24,21,6,-19,39,19,10,-4,39,41,17,11,ENTRY
-53,21,57,78,121,122,123,40,74,-33,10,-53,163,45,89,21,71,55,100,110,55,37,-1,18,ENTRY
75,75,8,83,46,70,83,44,-9,72,35,75,-50,33,20,66,-76,-13,-13,25,-70,-29,-68,-1,ENTRY
-17,24,19,43,91,60,64,71,45,-13,35,-17,70,36,53,28,111,63,84,53,136,113,141,94,ENTRY
-82,12,89,101,43,91,60,64,-17,-12,-70,-82,28,-25,-35,-99,53,24,-17,-54,94,51,14,-29,ENTRY
31,58,2,60,91,90,46,28,34,-12,19,31,-27,-22,8,65,-26,-14,-28,4,-42,-20,-52,5,ENTRY
-26,13,41,54,35,66,56,39,13,-1,-20,-26,-2,2,14,-13,24,4,6,-28,40,36,21,-2,ENTRY
49,75,43,118,93,177,212,418,-8,33,8,49,-38,39,98,41,-26,-81,13,11,136,-146,154,23,ENTRY
-56,15,58,73,132,75,26,38,101,-26,33,-56,50,39,41,45,51,41,-6,-6,27,22,-13,-5,ENTRY
67,113,26,139,85,129,75,114,-46,46,-8,67,-106,-37,-47,21,-102,-71,-135,-39,-140,-80,-105,-35,ENTRY
284,304,65,369,141,185,377,170,-53,271,43,284,-163,140,-44,231,-439,-93,-85,121,-368,-114,-313,-155,ENTRY
-173,188,176,364,95,62,80,115,17,-34,-303,-173,8,-3,-305,-156,26,-6,-290,-165,96,22,-227,-147,ENTRY
42,89,26,115,231,364,95,62,-100,-50,66,42,-273,-208,41,-58,-256,-242,-262,-231,-265,-211,-264,-214,ENTRY
-95,12,112,124,179,179,115,231,161,-1,54,-95,122,28,83,66,164,113,104,27,64,63,170,69,ENTRY
114,121,16,137,74,97,76,113,0,129,66,114,-8,89,49,114,-29,49,-12,106,-97,23,-1,85,ENTRY
-54,32,60,92,167,103,60,59,83,-71,4,-54,5,11,22,29,42,-9,-41,-49,19,10,-23,-12,ENTRY
70,82,5,87,41,33,68,59,19,58,12,70,-6,65,11,89,-41,23,4,64,-92,-20,-48,29,ENTRY
-41,4,51,55,29,28,41,69,6,3,-23,-41,24,15,-12,-35,41,28,14,-17,86,32,46,0,ENTRY
-50,2,88,90,62,73,95,123,-8,-22,-50,-50,13,-6,-23,-58,-30,-27,-22,-37,79,5,38,-80,ENTRY
85,85,14,99,49,35,67,42,-1,85,35,85,-29,66,2,84,-9,67,35,56,-4,66,9,76,ENTRY
-66,24,72,96,61,79,160,120,11,-9,-44,-66,47,-1,-18,-55,131,34,98,-19,62,20,44,65,ENTRY
40,64,33,97,207,115,64,98,-97,-26,84,40,-200,-127,-109,-57,-223,-175,-208,-160,-248,-236,-235,-183,ENTRY
-23,16,48,64,98,209,81,104,-25,-61,-27,-23,168,-16,129,-48,184,129,146,145,249,201,241,161,ENTRY
16,17,64,81,104,74,71,67,65,72,95,16,10,84,77,81,-5,43,33,26,30,48,34,11,ENTRY
48,56,5,61,82,17,15,21,-67,-15,6,48,-77,-25,-69,-19,-74,-24,-70,-29,-82,-31,-71,-26,ENTRY
-24,10,30,40,40,35,33,14,22,-11,-11,-24,49,26,21,-2,66,39,32,25,66,65,39,42,ENTRY
-29,9,31,40,29,35,39,47,9,-4,-15,-29,14,11,6,-20,-1,0,-1,-15,-8,-15,-8,-30,ENTRY
15,15,6,21,13,24,29,23,-5,8,0,15,-3,15,18,10,-14,-4,4,12,-25,-9,-7,1,ENTRY
-30,3,38,41,66,66,55,73,-36,-28,-3,-30,2,-28,-3,-66,39,-8,6,-28,103,46,78,9,ENTRY
-41,8,41,49,54,24,46,31,29,-23,-18,-41,43,28,3,-12,19,9,6,2,35,13,-5,-22,ENTRY
56,57,11,68,46,38,46,33,-25,26,4,56,12,42,12,31,-32,34,12,68,-54,9,-26,24,ENTRY
-25,33,25,58,62,52,149,48,14,-19,-15,-25,8,-36,-42,-11,52,2,93,-17,95,52,42,27,ENTRY
43,48,0,48,80,82,48,90,31,43,75,43,0,33,67,74,3,33,33,43,-77,-35,7,46,ENTRY
102,102,4,106,39,114,159,105,-8,77,10,102,-46,34,42,94,73,42,95,56,-25,75,74,175,ENTRY
-15,7,15,22,40,22,35,21,31,-6,12,-15,18,15,15,16,35,11,24,3,49,31,30,20,ENTRY
-4,16,13,29,22,40,22,35,-15,-6,-13,-4,16,-12,-1,-19,3,9,2,12,20,5,11,-1,ENTRY
-13,3,38,41,29,22,40,22,-4,12,0,-13,-19,6,-13,-17,12,0,-1,-32,-1,21,2,-1,ENTRY
94,112,5,117,102,56,56,91,-55,44,29,94,-56,13,-48,39,-77,2,-59,38,-153,-60,-86,17,ENTRY
30,34,5,39,54,31,43,37,-38,-8,7,30,-62,-29,-37,-8,-70,-47,-43,-32,-59,-42,-44,-40,ENTRY
-16,19,80,99,137,81,172,66,110,49,87,-16,150,149,131,94,186,179,252,134,207,218,185,170,ENTRY
-31,64,78,142,99,137,81,172,-16,-33,-76,-31,94,16,11,-47,134,116,55,63,170,146,176,103,ENTRY
23,53,37,90,44,90,133,67,-16,29,-17,23,-49,7,7,7,-128,-100,-57,-26,-176,-120,-143,-105,ENTRY
26,50,8,58,90,44,90,133,23,-3,29,26,7,26,12,49,-26,4,36,33,-105,-103,-28,0,ENTRY
49,54,3,57,37,49,46,52,-18,27,7,49,-35,3,-5,31,-46,-19,-30,14,-15,0,-5,3,ENTRY
-82,0,99,99,91,107,67,73,48,0,-8,-82,37,34,42,-34,38,44,12,-45,89,33,7,-44,ENTRY
-24,11,37,48,37,80,65,37,5,-17,-28,-24,35,-1,31,-19,76,40,57,11,86,67,56,52,ENTRY
48,52,21,73,57,71,48,37,-27,26,10,48,-86,-19,-21,21,-110,-54,-79,-38,-105,-71,-107,-62,ENTRY
-86,9,92,101,107,147,99,145,82,-19,-13,-86,225,85,131,-4,299,219,217,139,202,173,217,213,ENTRY
-21,10,48,58,58,49,57,47,36,18,18,-21,50,48,39,15,89,66,65,29,111,109,98,68,ENTRY
-16,13,39,52,58,58,49,57,-21,-25,-19,-16,15,-7,-1,-37,29,23,20,-1,68,41,46,13,ENTRY
2,29,16,45,65,100,77,70,-50,-34,-14,2,7,-43,12,-48,-31,-29,3,9,-24,-58,-33,-29,ENTRY
6,23,19,42,45,65,100,77,2,9,12,6,-48,-25,-2,8,9,-34,24,-42,-29,-20,15,15,ENTRY
6,29,14,43,42,45,65,100,6,1,0,6,8,10,12,12,-42,-24,-2,14,15,-33,24,-36,ENTRY
7,19,9,28,101,18,13,35,-51,-39,34,7,-52,-47,-57,-44,-54,-44,-59,-45,-77,-64,-57,-47,ENTRY
19,31,9,40,28,101,18,13,7,19,7,19,-44,-20,41,26,-45,-28,-50,-25,-47,-25,-52,-26,ENTRY
-29,0,43,43,67,44,63,34,46,-4,20,-29,57,40,41,17,90,68,88,28,78,79,70,61,ENTRY
-36,1,64,65,43,67,44,63,-29,-15,-37,-36,17,-19,-17,-65,28,25,4,-19,61,53,51,-8,ENTRY
-29,0,34,34,30,10,28,13,20,-3,-7,-29,20,18,-6,-9,41,18,12,-9,38,34,13,12,ENTRY
-56,3,66,69,34,30,10,28,-29,-24,-59,-56,-9,-27,-66,-85,-9,-6,-65,-65,12,-6,-47,-65,ENTRY
-27,16,27,43,32,16,27,63,12,-15,-26,-27,13,5,-22,-15,21,-4,-20,-14,74,11,31,-6,ENTRY
-20,0,26,26,43,32,16,27,-27,-21,-4,-20,-15,-36,-30,-47,-14,-16,-26,-35,-6,-25,-24,-34,ENTRY
81,86,1,87,65,81,46,163,-30,32,10,81,-111,-29,-35,51,-103,-53,-94,-30,50,-24,52,-22,ENTRY
-26,13,61,74,71,115,86,53,52,16,13,-26,113,57,98,26,76,90,102,87,87,92,71,50,ENTRY
-17,9,50,59,74,71,115,86,-26,-28,-13,-17,26,-12,0,-43,87,29,85,9,50,62,89,70,ENTRY
-60,9,69,78,44,26,46,46,-26,-31,-65,-60,-16,-20,-72,-86,-10,-30,-62,-76,8,-3,-35,-70,ENTRY
99,99,9,108,74,80,78,44,-26,55,21,99,-69,9,-19,73,-129,-30,-60,30,-155,-61,-125,-30,ENTRY
48,54,5,59,51,18,32,73,-27,22,14,48,-21,20,-21,21,-39,0,-27,27,-96,-58,-44,9,ENTRY
-9,7,26,33,42,30,59,51,36,17,26,-9,38,37,34,27,86,50,76,29,59,72,90,77,ENTRY
-11,12,28,40,33,42,30,59,-9,-9,-16,-11,27,8,10,-20,29,28,18,16,77,41,60,18,ENTRY
-13,11,19,30,52,20,25,23,32,5,27,-13,44,33,23,19,53,42,37,31,40,36,29,40,ENTRY
-46,1,49,50,30,52,20,25,-13,-16,-36,-46,19,-11,-9,-59,31,17,-13,-27,40,26,1,-15,ENTRY
-96,32,106,138,80,80,44,124,37,-1,-59,-96,107,37,-21,-59,103,106,12,11,46,54,40,7,ENTRY
8,15,38,53,42,56,48,70,-16,14,3,8,-65,-21,-18,-8,-77,-39,-44,-57,-24,-44,-27,-69,ENTRY
83,87,2,89,53,42,56,48,8,47,11,83,-8,61,14,91,-57,26,-7,75,-69,8,-33,26,ENTRY
61,76,13,89,65,57,26,41,-39,12,-12,61,-90,-18,-50,22,-83,-22,-85,-29,-56,-21,-69,-22,ENTRY
28,45,10,55,89,65,57,26,61,25,59,28,22,37,47,89,-29,7,9,50,-22,3,-26,-1,ENTRY
33,41,19,60,66,40,15,35,-31,12,18,33,-41,-16,-36,2,-31,11,-34,-8,-52,-4,-29,2,ENTRY
19,43,9,52,60,66,40,15,33,9,17,19,2,21,35,52,-8,-7,-19,21,2,20,-17,11,ENTRY
-11,10,15,25,36,39,56,39,2,-10,1,-11,13,-1,13,-9,48,10,41,2,65,48,62,37,ENTRY
-7,15,10,25,29,22,25,36,-8,-14,-10,-7,5,-7,-10,-15,-6,-7,-7,-2,-4,-17,-6,-13,ENTRY
37,42,13,55,56,61,163,89,-48,2,3,37,-44,-13,-7,-11,-139,-101,7,-7,-100,-124,-90,-102,ENTRY
25,38,12,50,55,56,61,163,37,24,29,25,-11,26,32,62,-7,11,22,14,-102,-77,36,18,ENTRY
-6,26,9,35,41,55,72,104,30,-2,4,-6,21,4,24,24,74,21,58,15,144,53,122,68,ENTRY
-15,35,21,56,35,41,55,72,-6,-3,-24,-15,24,-5,-20,-21,15,1,0,9,68,18,34,0,ENTRY
-52,4,62,66,47,56,35,41,15,9,-10,-52,0,4,-6,-37,-6,1,-30,-52,24,-1,-26,-58,ENTRY
6,36,14,50,50,96,161,110,0,5,5,6,39,12,58,6,-62,-95,16,45,-166,-148,-88,-56,ENTRY
71,91,16,107,50,50,96,161,6,73,16,71,6,78,21,77,45,85,74,77,-56,-22,32,116,ENTRY
-1,18,12,30,61,22,39,29,15,-28,3,-1,7,15,7,14,-3,-17,-8,6,-3,-7,-8,-4,ENTRY
-16,7,18,25,30,61,22,39,-1,-10,-5,-16,14,-38,-2,-17,6,5,2,-2,-4,-27,-13,-10,ENTRY
-60,16,61,77,25,30,61,22,-16,-17,-69,-60,-17,-27,-74,-76,-2,-55,-71,-77,-10,-12,-67,-62,ENTRY
-30,24,38,62,43,49,50,41,20,0,-19,-30,53,12,-1,-10,20,11,-1,23,-3,-6,-27,-10,ENTRY
-34,26,50,76,62,43,49,50,-30,-22,-36,-34,-10,-22,-55,-64,23,-10,-37,-44,-10,-11,-37,-11,ENTRY
-10,31,87,118,57,68,54,61,11,51,-10,-10,-25,51,1,1,15,42,-22,-35,27,60,3,5,ENTRY
-30,4,102,106,118,57,68,54,-10,-15,-3,-30,1,36,-13,-40,-35,36,-2,-29,5,27,-25,-65,ENTRY
-98,7,110,117,130,70,70,101,58,-9,4,-98,90,33,-14,-40,98,79,32,-8,178,102,86,0,ENTRY
16,53,17,70,205,89,62,104,125,-10,125,16,60,93,112,141,78,61,53,76,14,44,78,94,ENTRY
41,41,24,65,121,78,199,172,-86,-28,28,41,-130,-72,-59,-45,12,-116,18,-89,178,77,184,53,ENTRY
8,8,54,62,65,121,78,199,41,38,41,8,-45,10,69,49,-89,-34,-18,-37,53,-78,59,-81,ENTRY
-9,1,15,16,33,23,38,13,-14,-20,-3,-9,-9,-17,-10,-23,14,-11,11,-18,22,20,17,5,ENTRY
-9,17,34,51,27,40,35,23,15,14,-10,-9,42,30,19,6,17,32,16,33,7,23,-5,8,ENTRY
-40,18,42,60,51,27,40,35,-9,-32,-41,-40,6,-18,-51,-49,33,-2,-22,-34,8,0,-25,-7,ENTRY
64,64,4,68,35,37,69,48,-18,42,9,64,-10,36,5,46,-55,-5,-4,54,-78,-23,-43,9,ENTRY
-2,9,16,25,47,28,68,35,29,0,22,-2,44,37,40,27,108,54,97,42,90,96,106,106,ENTRY
-15,11,15,26,25,47,28,68,-2,-16,-17,-15,27,-16,5,-17,42,21,23,12,106,38,80,27,ENTRY
14,25,9,34,31,44,35,36,-11,3,0,14,-53,-30,-20,3,-33,-35,-34,-39,-59,-42,-40,-19,ENTRY
24,59,0,59,34,31,44,35,14,15,-10,24,3,18,-10,38,-39,-15,-30,27,-19,-20,-44,-15,ENTRY
-41,23,41,64,105,67,65,60,104,-1,40,-41,61,49,52,63,116,61,62,20,146,99,95,75,ENTRY
-49,28,59,87,111,135,96,144,46,-14,10,-49,106,-13,35,-3,159,97,106,57,221,154,211,110,ENTRY
-18,18,27,45,47,44,92,50,31,-7,-5,-18,45,19,18,13,80,21,68,27,80,61,66,62,ENTRY
-36,8,47,55,45,47,44,92,-18,-16,-26,-36,13,-23,-31,-54,27,3,-8,-23,62,5,42,-9,ENTRY
-7,58,7,65,37,37,50,72,-26,-29,-57,-7,-2,-27,-55,-33,-21,-21,-36,-9,-17,-62,-55,-28,ENTRY
-6,19,16,35,65,37,37,50,-7,3,33,-6,-33,-26,-24,-13,-9,-24,-22,-39,-28,-18,-3,-15,ENTRY
-3,35,9,44,93,114,98,47,56,4,53,-3,-23,-46,24,53,-105,-99,-45,-26,-107,-118,-115,-108,ENTRY
21,30,5,35,44,93,114,98,-3,17,26,21,53,21,79,18,-26,-29,50,74,-108,-82,-19,-5,ENTRY
-43,56,44,100,71,67,68,125,36,-16,-45,-43,78,13,-20,-7,52,51,19,35,91,-5,20,9,ENTRY
-31,27,36,63,100,71,67,68,-43,-39,-2,-31,-7,-55,-47,-74,35,-26,-22,-38,9,12,17,4,ENTRY
-47,25,47,72,48,47,26,36,0,-11,-35,-47,39,-2,-27,-47,54,33,-13,-8,57,50,14,7,ENTRY
15,20,6,26,36,27,23,36,3,17,27,15,18,21,22,18,-3,16,13,33,-3,4,14,12,ENTRY
19,20,17,37,32,76,81,78,4,29,24,19,-44,-33,6,23,-55,-40,4,-25,-11,-31,10,-36,ENTRY
27,30,5,35,37,32,76,81,19,15,17,27,23,44,41,46,-25,-18,23,50,-36,-25,21,2,ENTRY
-10,64,16,80,111,124,116,76,11,-34,-3,-10,101,-12,32,1,34,8,44,91,7,-1,-5,24,ENTRY
-115,3,253,256,80,111,124,116,-10,122,-54,-115,1,88,-57,-125,91,110,-22,-114,24,130,-10,-24,ENTRY
-17,19,55,74,91,81,51,74,65,22,39,-17,90,47,54,48,93,99,76,73,89,126,126,76,ENTRY
-115,11,131,142,74,91,81,51,-17,-39,-107,-115,48,-17,-68,-132,73,8,-53,-67,76,60,-31,-42,ENTRY
130,163,9,172,113,88,34,93,-77,27,-32,130,-162,-23,-107,53,-166,-36,-174,-32,-245,-117,-196,-36,ENTRY
188,221,23,244,172,113,88,34,130,202,130,188,53,229,98,318,-32,179,23,241,-36,166,-44,156,ENTRY
-79,3,90,93,43,65,70,96,9,-20,-70,-79,30,-15,-43,-70,21,20,-3,-49,-52,-55,-52,-58,ENTRY
-4,21,13,34,93,43,65,70,-79,-81,-22,-4,-70,-101,-92,-83,-49,-96,-65,-74,-58,-61,-25,-53,ENTRY
45,46,8,54,78,70,48,66,-19,5,29,45,-6,32,48,26,-46,2,-4,39,-88,-57,-45,-1,ENTRY
45,62,12,74,54,78,70,48,45,49,29,45,26,54,58,90,39,81,77,71,-1,51,25,84,ENTRY
-9,18,19,37,45,41,17,51,-21,-28,-20,-9,12,-13,-9,-30,24,17,-3,3,75,34,48,15,ENTRY
-12,8,27,35,37,45,41,17,-9,-4,-2,-12,-30,-32,-22,-21,3,-17,-11,-42,15,13,-5,-9,ENTRY
-5,12,28,40,35,37,45,41,-12,-4,-9,-5,-21,-8,-11,-17,-42,-36,-31,-26,-9,-21,-20,-47,ENTRY
236,274,19,293,142,538,58,42,-57,159,8,236,-440,-187,58,179,-460,-217,-452,-204,-460,-214,-465,-224,ENTRY
6,36,26,62,88,113,115,189,23,-3,23,6,-73,-56,-5,29,-82,-147,-94,-67,-83,-158,-31,-76,ENTRY
35,39,7,46,77,62,88,113,41,25,56,35,47,57,73,76,70,54,96,82,-26,1,68,105,ENTRY
41,60,17,77,62,88,113,115,6,32,17,41,29,29,40,47,-67,-24,12,70,-76,-115,-77,-26,ENTRY
-13,6,21,27,38,41,39,41,20,-10,1,-13,3,2,16,7,33,7,19,-10,44,37,51,20,ENTRY
-42,3,44,47,27,38,41,39,-13,-19,-39,-42,7,-29,-38,-55,-10,-17,-23,-35,20,-12,-20,-52,ENTRY
-20,26,32,58,42,47,27,38,0,3,-13,-20,-42,-32,-43,-20,-55,-51,-82,-62,-35,-61,-81,-75,ENTRY
0,33,9,42,47,27,38,41,-42,-35,-30,0,-55,-54,-69,-42,-35,-64,-68,-55,-52,-52,-53,-35,ENTRY
95,95,1,96,54,51,33,27,-14,53,11,95,-22,60,15,81,-35,51,-12,73,-32,55,-14,60,ENTRY
50,60,19,79,96,54,51,33,95,68,85,50,81,121,96,145,73,128,100,131,60,119,73,123,ENTRY
50,50,26,76,138,66,76,21,-91,-36,26,50,-54,-15,-25,-41,-130,-54,-54,-4,-133,-65,-120,-80,ENTRY
43,51,1,52,76,138,66,76,50,18,42,43,-41,-18,68,93,-4,3,17,2,-80,-36,-12,39,ENTRY
-34,11,45,56,98,73,56,63,-1,-20,22,-34,40,3,20,-35,55,41,41,6,65,54,61,21,ENTRY
-23,2,56,58,56,98,73,56,-34,-12,-14,-23,-35,-32,8,-57,6,-9,6,-58,21,29,27,-17,ENTRY
-2,73,36,109,398,53,48,37,201,-59,230,-2,199,211,155,199,202,224,163,197,196,221,149,200,ENTRY
-130,5,168,173,109,398,53,48,-2,2,-62,-130,199,-57,168,-132,197,213,93,69,200,226,101,67,ENTRY
129,137,28,165,164,65,180,140,-122,29,28,129,-168,-21,-121,7,-215,-179,-164,-39,-194,-87,-112,-86,ENTRY
51,93,0,93,165,164,65,180,129,23,95,51,7,52,123,180,-39,2,-26,58,-86,-156,-69,12,ENTRY
33,34,36,70,90,149,104,102,-66,-1,19,33,-187,-126,-47,-33,-139,-141,-107,-154,-118,-131,-99,-106,ENTRY
44,54,17,71,70,90,149,104,33,25,24,44,-33,24,43,77,-154,-101,-23,11,-106,-116,-83,-110,ENTRY
-12,4,34,38,74,86,52,37,-47,-45,-9,-12,20,-37,11,-59,14,-5,9,8,22,15,14,2,ENTRY
-74,0,77,77,38,74,86,52,-12,-31,-70,-74,-59,-76,-79,-86,8,-68,-59,-133,2,-36,-61,-66,ENTRY
27,31,5,36,40,32,27,48,-26,2,6,27,-46,-18,-22,1,-62,-30,-39,-19,-16,-31,-19,-35,ENTRY
15,54,11,65,36,40,32,27,27,21,-8,15,1,23,-2,42,-19,3,-30,16,-35,-9,-47,-4,ENTRY
-23,4,27,31,34,29,28,51,24,-6,-3,-23,44,22,20,1,62,39,36,21,54,36,56,39,ENTRY
50,51,7,58,40,65,52,50,15,53,35,50,-18,22,29,65,0,27,21,32,-3,25,17,50,ENTRY
-10,76,24,100,122,53,44,62,64,-27,-5,-10,92,78,31,54,91,86,30,82,63,69,31,81,ENTRY
-34,36,57,93,100,122,53,44,-10,-1,6,-34,54,-28,1,-44,82,77,37,20,81,85,36,48,ENTRY
48,92,5,97,56,52,60,26,-6,26,-15,48,-9,32,-13,42,-43,7,-30,39,-28,1,-70,5,ENTRY
37,41,3,44,35,33,30,71,-14,23,14,37,-15,2,-9,23,-20,3,-11,22,-81,-42,-15,17,ENTRY
18,18,12,30,26,30,44,35,-9,18,14,18,-8,6,6,9,29,19,33,10,15,42,47,47,ENTRY
29,34,16,50,22,27,16,54,6,35,7,29,-10,30,7,35,-15,26,-8,19,0,9,13,14,ENTRY
-36,17,40,57,34,17,29,27,10,-12,-35,-36,19,7,-33,-26,35,13,-15,-17,51,39,9,-1,ENTRY
-15,10,15,25,30,32,57,34,11,-15,-10,-15,4,-14,-7,-4,-32,-36,-4,-11,-22,-48,-39,-47,ENTRY
21,26,9,35,50,59,33,40,3,6,21,21,-33,-21,3,24,-42,-34,-36,-12,-41,-31,-26,-21,ENTRY
10,24,16,40,45,35,50,59,-8,13,18,10,13,9,4,2,16,15,25,23,-20,-12,7,26,ENTRY
-28,10,116,126,90,67,92,81,-32,1,-35,-28,23,44,-15,-60,2,26,-8,-5,70,87,42,-26,ENTRY
-9,16,29,45,86,61,90,96,33,-15,26,-9,33,45,61,24,49,33,78,24,-9,7,58,40,ENTRY
-13,31,25,56,45,86,61,90,-9,-17,-28,-13,24,-32,-2,-22,24,28,33,11,40,16,50,11,ENTRY
-3,12,26,38,44,36,26,37,-9,-18,-12,-3,-12,-7,-9,-12,-10,-8,-20,-15,-23,-18,-19,-13,ENTRY
-11,23,12,35,91,62,66,82,69,-7,49,-11,75,30,57,58,107,42,73,64,83,30,77,96,ENTRY
-5,23,14,37,35,91,62,66,-11,-3,-5,-5,58,-10,44,-16,64,27,52,53,96,39,68,59,ENTRY
-33,18,45,63,37,35,91,62,-5,-2,-28,-33,-16,-5,-33,-38,53,-12,16,-49,59,25,24,20,ENTRY
38,42,20,62,96,69,95,98,-65,-29,5,38,-94,-47,-40,-27,-136,-115,-82,-56,-63,-101,-65,-98,ENTRY
75,79,1,80,62,96,69,95,38,56,38,75,-27,27,43,113,-56,9,-2,48,-98,-59,-44,19,ENTRY
-132,10,158,168,121,130,60,77,93,10,-37,-132,202,117,79,-39,153,168,60,70,210,179,88,21,ENTRY
-86,21,103,124,168,121,130,60,-132,-141,-97,-86,-39,-131,-134,-218,70,-24,-18,-125,21,27,-37,-16,ENTRY
86,97,20,117,69,99,47,48,-10,59,11,86,-86,8,-10,76,-80,-1,-71,0,-111,-8,-77,6,ENTRY
-31,14,34,48,73,59,81,78,0,-42,-17,-31,10,-16,-5,-31,37,-22,11,-21,59,2,32,6,ENTRY
67,67,3,70,135,45,63,93,-68,-52,13,67,-44,-8,-33,-1,-84,-24,-31,23,-138,-74,-51,-17,ENTRY
75,77,0,77,70,135,45,63,67,72,65,75,-1,20,78,142,23,64,32,74,-17,48,34,98,ENTRY
-20,7,20,27,16,28,28,31,-10,-16,-27,-20,11,-10,-9,-30,20,2,3,-9,30,4,8,0,ENTRY
-16,34,25,59,43,36,31,61,-33,-25,-41,-16,0,-27,-50,-49,-9,-5,-33,-16,-53,-44,-42,-25,ENTRY
-11,9,18,27,60,62,36,49,-32,-33,0,-11,-4,-30,5,-43,-4,-30,-21,-15,17,-11,11,-15,ENTRY
-41,1,44,45,48,59,36,79,-9,-39,-36,-41,25,-30,-16,-50,14,5,-4,-16,82,17,51,-27,ENTRY
91,101,5,106,82,68,80,72,-19,51,27,91,-38,53,15,72,-77,-5,-31,53,-62,-36,-70,14,ENTRY
76,92,23,115,70,102,45,106,-20,62,17,76,-66,-2,-15,56,-72,12,-58,10,19,22,13,4,ENTRY
-54,12,54,66,62,81,67,62,23,-35,-39,-54,30,-16,-1,-31,45,14,15,-24,48,5,1,-9,ENTRY
-126,26,138,164,83,66,62,81,11,-14,-95,-126,-43,-31,-129,-115,-20,-66,-168,-169,-13,-47,-130,-146,ENTRY
16,17,9,26,30,58,25,17,-13,2,6,16,-55,-36,-4,3,-35,-34,-35,-39,-31,-23,-32,-19,ENTRY
18,20,8,28,26,30,58,25,16,17,15,18,3,19,21,34,-39,-19,11,21,-19,-17,-20,-21,ENTRY
9,20,51,71,57,92,56,31,17,47,33,9,-54,6,27,26,-109,-50,-65,-45,-108,-69,-109,-100,ENTRY
-57,14,57,71,45,52,26,43,14,-22,-48,-57,56,9,-10,-43,51,50,5,-1,15,14,-14,-6,ENTRY
-21,18,31,49,71,45,52,26,-57,-47,-25,-21,-43,-69,-73,-78,-1,-38,-35,-64,-6,3,-20,-22,ENTRY
-20,17,25,42,38,48,62,65,13,-14,-18,-20,59,16,22,-7,96,49,69,39,57,59,82,76,ENTRY
-49,10,57,67,19,44,25,26,2,6,-42,-49,27,-8,-31,-47,17,17,-25,-22,25,11,-30,-32,ENTRY
4,10,21,31,34,44,55,43,15,21,24,4,-5,11,24,19,-34,-14,10,-1,-23,-23,-11,-30,ENTRY
-15,26,15,41,17,18,24,15,-3,-13,-37,-15,-11,-12,-35,-18,23,2,-15,-11,29,15,-11,8,ENTRY
-144,18,149,167,146,148,175,145,-107,-141,-162,-144,25,-113,-132,-251,91,-62,-54,-119,87,62,40,-53,ENTRY
66,83,92,175,145,328,80,77,-4,124,94,66,-158,-43,110,62,-135,-22,-117,-92,-103,-22,-120,-69,ENTRY
-10,13,30,43,93,55,45,56,-75,-55,-5,-10,-20,-55,-43,-85,-35,-34,-32,-30,1,-26,-13,-45,ENTRY
45,88,10,98,87,206,122,163,20,18,7,45,-25,-104,4,65,37,1,25,20,138,36,101,82,ENTRY
91,115,74,189,171,122,91,60,-32,77,59,91,-133,21,-46,59,-212,-47,-145,-42,-159,-52,-181,-121,ENTRY
60,71,36,107,189,171,122,91,91,22,104,60,59,99,163,151,-42,43,58,119,-121,-25,-41,18,ENTRY
-101,10,112,122,91,60,51,70,-79,-68,-99,-101,-26,-73,-135,-180,-68,-65,-136,-127,-27,-85,-137,-169,ENTRY
75,76,1,77,136,135,69,83,-93,-48,11,75,-219,-149,-91,-18,-212,-162,-170,-144,-160,-149,-143,-137,ENTRY
50,58,19,77,77,77,136,135,-9,42,42,50,66,59,59,41,-27,11,70,116,-153,-90,-32,23,ENTRY
-126,3,132,135,69,83,70,73,7,-13,-79,-126,59,0,-52,-119,50,39,-26,-67,79,22,-40,-76,ENTRY
-23,4,24,28,22,30,23,39,-2,-2,-8,-23,10,-16,-14,-25,26,8,3,-13,48,11,22,3,ENTRY
25,51,36,87,44,108,65,142,17,46,3,25,-74,-29,-8,42,-54,-33,-55,-49,-147,-103,-48,-29,ENTRY
78,83,9,92,87,44,108,65,25,51,46,78,42,97,49,103,-49,22,38,120,-29,18,-9,29,ENTRY
-93,32,110,142,148,119,90,91,-125,-125,-119,-93,-28,-129,-152,-218,-50,-55,-107,-121,-86,-97,-148,-143,ENTRY
-73,21,108,129,200,58,86,70,130,-30,41,-73,150,149,78,57,182,155,112,77,137,154,95,109,ENTRY
-284,0,288,288,129,200,58,86,-73,-104,-263,-284,57,-134,-222,-357,77,45,-185,-227,109,51,-151,-207,ENTRY
93,121,14,135,105,69,93,65,35,37,7,93,-18,84,18,128,-73,25,-17,75,-35,11,-59,20,ENTRY
35,35,70,105,69,93,65,114,-53,47,11,35,-108,-12,-24,-18,-70,-26,-66,-73,-146,-70,-61,-35,ENTRY
-38,8,40,48,30,62,33,49,-9,-11,-29,-38,35,-13,1,-47,36,24,9,-3,56,23,24,-2,ENTRY
5,11,13,24,30,31,28,51,8,2,8,5,6,19,26,13,-6,2,6,11,11,-1,26,-1,ENTRY
15,19,15,34,24,30,31,28,5,17,7,15,13,19,15,20,11,36,33,28,-1,19,13,26,ENTRY
59,104,0,104,175,113,46,88,-76,-67,4,59,-171,-112,-103,-17,-165,-150,-208,-112,-106,-132,-148,-106,ENTRY
71,99,6,105,104,175,113,46,59,77,76,71,-17,10,80,130,-112,-35,-27,54,-106,-73,-132,-41,ENTRY
-95,18,95,113,46,88,43,57,6,-38,-105,-95,65,-20,-45,-89,78,50,-20,-30,85,39,-17,-17,ENTRY
7,18,39,57,66,80,208,57,-18,28,37,7,-55,-40,-17,-11,-175,-139,12,-48,-220,-177,-177,-168,ENTRY
-120,78,130,208,57,28,20,45,-45,-38,-189,-120,-26,-43,-223,-165,-18,-23,-211,-146,-33,-35,-198,-138,ENTRY
-69,5,74,79,26,40,23,47,14,-5,-58,-69,-9,-16,-55,-55,0,-14,-70,-78,-19,-34,-66,-69,ENTRY
-31,12,43,55,31,59,139,62,0,-3,-27,-31,51,9,13,-31,-10,-10,74,20,-31,-24,-17,-41,ENTRY
-31,6,48,54,47,48,50,45,-32,-23,-30,-31,4,-22,-28,-63,32,0,-4,-27,29,27,18,1,ENTRY
55,70,6,76,46,24,19,43,-3,42,12,55,7,49,-3,52,7,59,2,62,-17,44,11,62,ENTRY
17,21,31,52,55,70,176,202,-14,6,9,17,-23,-18,0,3,-98,-118,6,-6,-273,-246,-96,-81,ENTRY
-31,4,50,54,50,74,92,52,-12,-7,-11,-31,55,3,23,-43,128,55,93,24,145,116,114,97,ENTRY
52,52,22,74,54,50,74,92,-31,24,4,52,-43,17,-7,21,24,27,27,9,97,79,97,76,ENTRY
88,93,10,103,67,80,42,52,58,97,61,88,-22,76,53,146,-9,76,15,66,-38,59,8,79,ENTRY
-248,4,265,269,78,45,61,148,31,0,-191,-248,29,30,-194,-217,31,44,-164,-219,111,-15,-136,-217,ENTRY
17,28,7,35,62,39,54,35,32,23,50,17,14,20,24,49,29,34,53,31,19,24,24,46,ENTRY
-26,21,37,58,56,37,63,34,-40,-37,-39,-26,-31,-32,-53,-66,0,-45,-40,-57,-26,-22,-46,-26,ENTRY
40,40,26,66,120,39,27,34,-95,-33,21,40,-68,-31,-58,-55,-51,-9,-48,-28,-54,-2,-34,-11,ENTRY
-33,35,36,71,15,24,20,35,-1,-10,-66,-33,18,2,-45,-34,14,5,-46,-15,4,-3,-39,-19,ENTRY
-28,1,32,33,71,15,24,20,-33,-32,6,-28,-34,-42,-60,-61,-15,-30,-39,-62,-19,-27,-40,-43,ENTRY
-47,8,53,61,75,89,55,179,11,-28,-14,-47,17,-36,-8,-36,-6,-1,-7,-30,46,-100,18,-53,ENTRY
118,123,27,150,65,51,89,173,-20,100,15,118,-10,116,17,98,-55,87,26,108,-222,-79,-56,63,ENTRY
-61,24,79,103,65,164,70,155,-50,-32,-70,-61,-4,-98,-37,-111,-9,-7,-40,-65,80,-6,46,-70,ENTRY
26,57,11,68,85,106,67,76,-55,-33,-16,26,-92,-73,-35,-29,-72,-79,-80,-66,-59,-78,-70,-46,ENTRY
-25,6,33,39,55,40,40,26,16,-11,5,-25,-10,-2,-1,-9,10,-2,-1,-35,20,6,-7,-15,ENTRY
-18,30,18,48,39,55,40,40,-25,-33,-42,-18,-9,-44,-37,-43,-35,-35,-43,-27,-15,-35,-43,-53,ENTRY
-76,4,99,103,80,137,182,81,-20,-47,-70,-76,64,-25,9,-96,110,58,137,-12,125,91,69,34,ENTRY
49,52,3,55,34,120,84,53,10,40,19,49,-83,-45,20,59,-144,-114,-85,-34,-112,-92,-94,-95,ENTRY
-50,1,54,55,51,100,73,155,-6,-38,-42,-50,20,-44,1,-56,64,9,27,-30,-3,-12,88,14,ENTRY
-119,9,123,132,46,56,70,76,-21,-33,-119,-119,25,-20,-96,-140,11,-20,-82,-94,20,-10,-66,-108,ENTRY
-43,8,45,53,25,55,85,17,-15,-21,-49,-43,8,-43,-41,-58,55,-28,4,-35,62,52,16,12,ENTRY
-65,11,65,76,55,64,46,65,14,-6,-27,-65,49,-15,-27,-51,58,35,5,-16,98,52,41,-7,ENTRY
-34,12,35,47,45,26,39,61,18,-9,-11,-34,33,8,-13,-16,16,7,-1,-1,50,-2,12,-18,ENTRY
-88,3,88,91,78,36,38,78,71,-4,-17,-88,100,69,14,-17,76,64,11,12,111,33,20,-12,ENTRY
-55,12,62,74,91,78,36,38,-88,-81,-64,-55,-17,-85,-81,-143,12,-12,-50,-72,-12,-17,-53,-43,ENTRY
162,164,137,301,161,51,65,74,110,284,144,162,77,373,123,272,34,313,77,239,76,305,78,196,ENTRY
-49,5,75,80,142,97,53,103,-26,-104,-42,-49,28,-23,-6,-75,20,18,-9,-21,87,41,64,-29,ENTRY
60,61,24,85,68,56,35,77,12,53,36,60,16,61,32,72,16,88,38,76,-18,61,53,76,ENTRY
40,61,10,71,69,74,88,72,-2,45,43,40,9,-11,-8,38,-13,-3,14,49,-43,-24,-23,27,ENTRY
9,11,9,20,25,32,46,31,21,16,21,9,-1,15,27,30,-39,-26,0,8,-50,-41,-30,-30,ENTRY
-27,8,37,45,28,65,50,10,-15,-7,-24,-27,23,-25,-5,-42,16,1,6,-4,16,20,-15,-11,ENTRY
-15,11,17,28,65,50,10,19,38,-18,19,-15,31,8,30,23,31,27,9,16,25,27,18,16,ENTRY
-29,9,29,38,29,23,19,41,-17,-25,-34,-29,-9,-26,-41,-46,-1,-10,-29,-38,-11,-33,-30,-30,ENTRY
-18,8,18,26,18,35,27,32,5,-12,-20,-18,33,-2,7,-13,9,7,8,15,-6,-12,-6,-9,ENTRY
-45,5,46,51,24,26,18,35,0,-5,-32,-45,-18,-17,-42,-45,-13,-29,-62,-63,15,-19,-35,-58,ENTRY
-9,55,20,75,156,71,57,44,80,-43,38,-9,25,36,32,71,36,24,6,16,52,39,8,27,ENTRY
-20,23,43,66,75,156,71,57,-9,3,12,-20,71,-40,50,-29,16,39,44,51,27,27,18,-4,ENTRY
-63,9,66,75,48,41,54,49,3,-9,-36,-63,10,1,-33,-60,29,-8,-29,-53,28,-8,-34,-34,ENTRY
61,63,0,63,62,83,56,92,-23,23,22,61,-58,-16,4,38,-81,-48,-55,3,-140,-79,-50,-20,ENTRY
-47,8,48,56,11,23,19,23,2,-4,-49,-47,19,-1,-34,-45,21,11,-26,-28,4,4,-29,-26,ENTRY
27,44,6,50,46,15,11,14,30,17,13,27,24,53,18,57,20,48,9,51,9,42,6,47,ENTRY
-4,16,11,27,34,21,37,101,-11,-12,-5,-4,-5,-16,-22,-15,-23,-17,-7,-9,69,-17,57,-27,ENTRY
70,70,1,71,52,132,96,52,20,50,31,70,-87,-17,44,90,-148,-87,-62,-17,-150,-113,-132,-78,ENTRY
-2,16,36,52,69,78,43,63,-43,-20,-3,-2,9,-9,17,-45,-8,17,8,7,28,10,21,-10,ENTRY
-232,14,241,255,79,68,65,64,19,-17,-193,-232,-1,-39,-226,-213,19,-15,-205,-233,10,-28,-219,-213,ENTRY
-64,0,71,71,55,28,61,85,-23,-33,-49,-64,-20,-30,-73,-87,12,-26,-36,-84,94,17,31,-52,ENTRY
-38,15,103,118,172,105,62,75,55,-51,3,-38,45,67,54,17,51,91,35,7,84,109,66,13,ENTRY
-73,46,77,123,118,172,105,62,-38,-99,-104,-73,17,-150,-101,-111,7,-32,-50,-56,13,-8,-69,-66,ENTRY
-43,11,52,63,49,47,26,30,-27,-32,-46,-43,-1,-32,-48,-70,9,-2,-39,-44,29,18,-15,-34,ENTRY
24,35,3,38,26,52,23,42,9,12,0,24,-21,3,17,33,-33,-8,-23,3,-59,-32,-28,-9,ENTRY
-42,16,49,65,57,63,79,32,-13,-46,-54,-42,0,-7,-9,-55,76,4,18,-42,67,53,20,34,ENTRY
37,50,29,79,52,68,53,49,-21,37,10,37,-56,-6,-17,16,-65,-23,-49,-19,-84,-36,-66,-28,ENTRY
-149,61,151,212,167,193,509,93,-21,-74,-119,-149,47,-68,-87,-170,527,21,318,-102,491,482,363,378,ENTRY
20,47,8,55,43,89,32,45,23,20,8,20,-54,-28,6,43,-50,-34,-57,-34,-62,-38,-48,-30,ENTRY
-107,22,107,129,77,51,125,73,-37,-71,-123,-107,-11,-43,-121,-144,60,-55,-59,-118,15,3,-53,-47,ENTRY
-32,2,33,35,24,26,19,20,-13,-19,-30,-32,0,-20,-29,-45,-10,-11,-27,-32,-16,-15,-30,-42,ENTRY
11,27,6,33,48,47,29,35,-5,2,17,11,-45,-33,-19,6,-64,-51,-55,-34,-96,-80,-78,-53,ENTRY
33,39,23,62,70,43,71,41,27,49,57,33,0,45,26,60,-19,30,39,33,-11,31,10,14,ENTRY
73,104,25,129,72,95,134,83,-7,81,24,73,-36,36,2,66,-156,-69,-64,37,-160,-108,-154,-83,ENTRY
-10,0,40,40,43,53,59,51,0,-2,1,-10,-26,1,14,-10,4,-16,3,-36,-43,-14,-3,-6,ENTRY
-45,4,46,50,40,43,53,59,-10,-39,-49,-45,-10,-41,-48,-55,-36,-38,-35,-55,-6,-55,-46,-81,ENTRY
-119,22,124,146,101,100,46,61,9,-49,-94,-119,-17,-17,-63,-110,-17,-53,-153,-136,0,-37,-122,-136,ENTRY
-41,5,41,46,22,7,23,10,-5,-17,-41,-41,-6,-11,-50,-46,-23,-27,-50,-47,-29,-31,-67,-64,ENTRY
-34,6,41,47,39,31,40,45,-2,-15,-23,-34,5,1,-15,-36,4,-14,-21,-29,28,-8,-10,-30,ENTRY
34,54,21,75,62,100,59,81,-22,15,2,34,-85,-38,-13,12,-119,-82,-98,-51,-182,-134,-128,-85,ENTRY
-116,13,122,135,93,67,65,88,40,4,-38,-116,59,-2,-70,-76,19,18,-52,-57,65,18,-29,-97,ENTRY
-46,8,52,60,34,46,69,52,25,-3,-29,-46,44,9,-5,-21,73,26,35,-2,68,61,53,27,ENTRY
-20,6,63,69,60,34,46,69,-46,-9,-18,-20,-21,-12,-47,-66,-2,0,-23,-41,27,17,17,-22,ENTRY
31,34,2,36,74,95,178,46,16,27,65,31,-65,-41,18,47,-207,-209,-67,-34,-203,-197,-187,-176,ENTRY
20,41,1,42,23,36,31,35,11,14,-5,20,-14,4,-2,31,-43,-22,-33,6,-58,-46,-53,-23,ENTRY
-116,0,136,136,50,103,49,39,2,-4,-90,-116,56,-24,-57,-114,102,73,-14,-60,96,92,-5,-14,ENTRY
-35,12,36,48,52,57,86,87,-1,0,4,-35,19,-6,3,-36,74,15,53,-16,105,70,109,39,ENTRY
133,133,3,136,204,444,81,77,38,24,92,133,-364,-237,71,171,-368,-290,-345,-231,-333,-253,-312,-235,ENTRY
-10,35,10,45,65,67,51,57,-50,-50,-30,-10,-35,-52,-30,-60,-16,-40,-34,-45,-24,-47,-35,-26,ENTRY
-66,12,121,133,99,78,155,116,-37,-29,-63,-66,-9,0,-55,-103,-120,-90,-68,-75,-32,-79,-96,-186,ENTRY
-10,13,24,37,24,49,27,29,-8,0,-13,-10,17,-15,-3,-18,12,17,7,7,-7,0,-8,2,ENTRY
11,12,33,45,35,39,60,38,-3,35,25,11,-33,5,-1,8,-54,-28,-13,-22,-65,-21,-28,-43,ENTRY
43,43,7,50,45,35,39,60,11,17,12,43,8,52,37,54,-22,22,11,51,-43,-11,-1,21,ENTRY
-69,11,77,88,55,39,70,65,13,-23,-56,-69,29,4,-45,-56,38,19,1,-40,-12,-9,-32,-31,ENTRY
-82,18,92,110,88,55,39,70,-69,-67,-89,-82,-56,-90,-145,-151,-40,-63,-134,-138,-31,-48,-88,-122,ENTRY
61,64,45,109,136,429,169,277,-50,-25,2,61,-330,-224,96,11,-304,-318,-258,-269,-99,-241,-73,-243,ENTRY
90,143,23,166,109,136,429,169,61,68,11,90,11,43,13,151,-269,-156,107,101,-243,-250,-247,-179,ENTRY
-113,49,151,200,530,285,238,500,335,-91,239,-113,137,168,253,222,68,104,142,24,-345,-371,-71,-45,ENTRY
-413,23,477,500,128,96,75,70,28,8,-364,-413,95,72,-332,-385,105,119,-306,-318,92,144,-286,-308,ENTRY
34,61,5,66,90,109,67,146,32,23,47,34,-28,0,43,66,14,4,5,6,-117,-83,-3,48,ENTRY
-140,17,141,158,92,107,44,47,-19,-28,-94,-140,46,-23,-74,-159,42,25,-89,-94,51,9,-102,-98,ENTRY
83,98,22,120,62,74,47,24,24,93,35,83,-9,60,14,107,-31,67,-6,74,-34,62,-34,52,ENTRY
15,21,12,33,24,12,15,24,5,20,11,15,4,30,9,20,2,19,1,19,34,52,43,63,ENTRY
10,17,0,17,15,33,24,12,13,8,6,10,28,11,27,23,33,31,38,38,32,41,36,43,ENTRY
13,13,2,15,33,24,12,15,15,3,21,13,20,23,32,28,19,33,30,33,17,22,22,32,ENTRY
29,43,1,44,31,35,100,29,-4,9,-4,29,-15,15,6,25,74,6,62,14,61,90,75,103,ENTRY
-29,15,34,49,40,86,88,44,-18,-32,-41,-29,38,-29,8,-47,118,42,81,9,147,122,117,89,ENTRY
19,25,31,56,102,43,22,28,6,-16,30,19,-17,18,5,25,-14,20,-14,2,-35,15,-13,5,ENTRY
-160,33,172,205,105,99,118,101,49,-18,-118,-160,26,-38,-144,-111,101,11,-76,-134,139,80,-24,-59,ENTRY
-17,40,40,80,94,86,170,84,-64,-68,-54,-17,-34,-49,-43,-81,100,-15,75,-51,147,87,91,83,ENTRY
-16,11,33,44,80,94,86,170,-17,-23,13,-16,-81,-91,-41,-33,-51,-72,-30,-97,83,-38,88,-67,ENTRY
56,66,7,73,73,61,53,74,25,55,55,56,-11,35,23,81,4,44,24,45,-45,18,19,60,ENTRY
19,35,1,36,73,73,61,53,56,13,50,19,81,68,105,75,45,48,73,100,60,57,74,64,ENTRY
-50,1,52,53,36,37,51,30,18,2,-15,-50,-6,-7,-23,-32,41,-4,-6,-56,20,22,-1,-9,ENTRY
28,33,7,40,26,33,38,39,8,33,19,28,-8,23,16,36,-23,8,6,20,-29,-19,-20,5,ENTRY
-41,28,53,81,20,26,57,57,6,5,-56,-41,-2,0,-55,-35,49,4,-20,-41,8,15,-9,8,ENTRY
-21,9,43,52,81,20,26,57,-41,-31,-2,-21,-35,-26,-58,-62,-43,-31,-57,-56,8,-27,-22,-62,ENTRY
-21,39,40,79,92,152,139,244,59,-14,-1,-21,79,-6,67,38,48,-4,56,58,157,21,186,27,ENTRY
-46,5,57,62,79,92,152,139,-21,-29,-12,-46,38,-43,-13,-67,58,-35,55,-8,27,-33,44,12,ENTRY
53,67,18,85,164,128,333,144,-98,-78,1,53,-176,-113,-70,-45,113,-131,117,-123,244,179,238,166,ENTRY
81,184,33,217,85,164,128,333,53,96,-36,81,-45,18,-35,134,-123,-17,-106,36,166,-35,81,-42,ENTRY
131,139,5,144,332,80,109,117,-53,-107,81,131,-78,52,-12,78,-25,6,-29,53,-99,9,-18,106,ENTRY
-3,15,4,19,76,48,34,38,23,-50,7,-3,-7,-11,18,20,8,-8,7,-10,29,6,25,5,ENTRY
-17,8,20,28,19,76,48,34,-3,-1,-10,-17,20,-51,-3,-20,-10,-12,8,3,5,-9,-3,-27,ENTRY
-65,16,68,84,55,28,19,76,6,-13,-42,-65,-11,-11,-67,-59,-14,-12,-77,-76,9,-62,-70,-79,ENTRY
142,180,27,207,162,120,249,207,-42,27,-18,142,-96,32,-55,100,-172,-120,-78,46,-139,-87,-87,-30,ENTRY
-39,2,41,43,73,42,42,51,-3,-36,-6,-39,33,-5,-6,-42,53,34,33,-6,90,48,56,14,ENTRY
-11,36,32,68,94,63,98,102,31,-33,-7,-11,58,45,40,20,42,48,78,47,22,-26,8,31,ENTRY
-2,50,18,68,68,94,63,98,-11,-16,-16,-2,20,-49,-23,-13,47,29,24,18,31,32,62,45,ENTRY
-53,1,83,84,68,68,94,63,-2,12,-4,-53,-13,-4,-20,-55,18,-37,-27,-66,45,41,20,-35,ENTRY
20,26,15,41,71,41,52,61,-52,-20,10,20,-27,-18,-18,-32,-61,-30,-19,-7,-49,-30,-10,-41,ENTRY
28,39,39,78,41,71,41,52,20,52,15,28,-32,32,25,48,-7,34,-3,-4,-41,22,-4,21,ENTRY
-123,8,131,139,142,128,449,63,46,-74,-71,-123,-25,-48,-59,-77,333,-97,213,-148,313,314,238,210,ENTRY
130,146,2,148,117,152,132,159,-90,19,-12,130,-188,-81,-77,40,-93,-70,-86,-58,54,28,39,37,ENTRY
54,98,2,100,96,95,68,103,19,-21,-25,54,-18,22,17,73,-43,-13,-45,36,-50,-58,-55,11,ENTRY
40,41,10,51,26,20,32,35,1,47,22,40,-8,36,5,41,-27,23,4,32,-3,21,5,13,ENTRY
27,30,6,36,51,26,20,32,40,23,38,27,41,70,60,67,32,59,43,68,13,46,42,59,ENTRY
-31,21,36,57,128,130,83,73,103,5,76,-31,34,-5,68,72,26,-21,5,3,35,20,36,-5,ENTRY
-47,32,57,89,89,60,92,47,-44,-63,-63,-47,-14,-51,-80,-91,51,-24,-21,-61,72,48,6,4,ENTRY
-38,21,60,81,72,63,134,55,15,-6,-15,-38,39,23,5,-23,143,46,99,1,121,117,91,105,ENTRY
-78,5,78,83,70,34,86,77,56,-3,-16,-78,75,56,7,-22,41,-4,-1,-3,91,15,9,-37,ENTRY
-20,5,29,34,83,70,34,86,-78,-69,-20,-20,-22,-72,-36,-98,-3,-13,-13,-42,-37,-73,-21,-23,ENTRY
37,37,5,42,53,33,28,12,5,15,26,37,12,28,19,42,17,33,19,34,11,51,21,54,ENTRY
28,34,15,49,50,113,69,86,19,18,19,28,-36,-51,13,47,-63,-31,-11,-8,-107,-79,-42,-35,ENTRY
46,56,4,60,49,50,113,69,28,35,24,46,47,53,43,74,-8,-16,37,93,-35,4,13,38,ENTRY
55,56,17,73,105,62,104,66,-18,38,70,55,-50,10,-1,37,-129,-58,-27,5,-90,-63,-70,-74,ENTRY
13,29,40,69,73,105,62,104,55,36,40,13,37,74,110,68,5,46,39,50,-74,-22,13,18,ENTRY
-11,28,16,44,46,35,65,23,-23,-31,-29,-11,-11,-33,-42,-34,48,-7,14,-22,48,38,17,37,ENTRY
61,70,0,70,41,65,29,60,17,55,26,61,-29,30,25,78,-38,11,-30,32,-89,-36,-46,23,ENTRY
-9,8,21,29,60,72,70,36,-51,-47,-16,-9,14,-45,-2,-60,78,23,64,5,85,67,74,69,ENTRY
-43,14,80,94,88,107,100,87,-5,-27,-33,-43,40,23,36,-48,65,9,15,-3,78,91,84,22,ENTRY
-80,20,97,117,58,54,35,27,14,7,-52,-80,58,26,-37,-66,34,49,-33,-22,38,31,-59,-46,ENTRY
30,31,35,66,50,130,85,117,15,35,19,30,-66,-11,53,45,-109,-46,-27,-36,-189,-141,-90,-79,ENTRY
-33,12,35,47,31,34,59,60,-23,-29,-45,-33,0,-25,-38,-56,25,-21,-9,-33,71,18,31,-8,ENTRY
54,54,1,55,36,27,82,65,15,37,18,54,0,45,17,69,-70,-21,6,54,-18,-19,-9,-16,ENTRY
-48,20,57,77,185,96,143,96,142,-23,85,-48,104,57,76,94,209,75,141,56,124,133,152,161,ENTRY
-46,24,117,141,77,185,96,143,-48,14,-50,-46,94,-9,35,-94,56,71,26,48,161,89,91,10,ENTRY
281,282,15,297,88,167,158,76,-18,278,69,281,-143,152,22,263,-285,6,-133,138,-305,-49,-270,-4,ENTRY
-20,16,60,76,30,40,79,96,-16,19,-27,-20,0,5,-31,-36,6,-33,-30,-20,97,41,61,-14,ENTRY
-16,9,21,30,40,79,96,77,16,-14,-4,-16,22,-52,-3,0,113,22,88,6,78,78,125,97,ENTRY
32,39,19,58,53,81,45,145,-25,-1,-6,32,29,10,33,7,28,59,46,61,-98,-66,21,60,ENTRY
54,65,16,81,45,145,98,90,-1,49,13,54,-127,-76,-12,53,-117,-127,-110,-73,-150,-97,-88,-63,ENTRY
65,71,10,81,85,87,132,59,-12,28,32,65,-11,37,43,53,-121,-67,-16,54,-173,-103,-125,-56,ENTRY
-52,2,57,59,62,68,101,46,27,3,6,-52,21,-4,5,-25,102,25,67,-31,123,85,72,50,ENTRY
-46,19,47,66,55,39,89,35,-45,-54,-65,-46,-27,-53,-80,-91,60,-28,-5,-73,76,42,11,14,ENTRY
-151,2,153,155,92,98,193,87,54,-34,-97,-151,-18,-30,-87,-97,121,-69,-31,-169,169,85,17,-30,ENTRY
16,16,19,35,59,40,84,72,6,-5,19,16,4,21,26,22,-72,-43,6,20,-11,-45,-8,-56,ENTRY
100,118,13,131,45,142,64,83,15,107,21,100,-88,-9,2,115,-125,-15,-82,12,-170,-91,-139,-25,ENTRY
-37,24,40,64,83,57,57,81,-45,-76,-57,-37,-5,-47,-54,-82,-4,-14,-21,-42,36,-12,5,-41,ENTRY
40,70,11,81,59,189,185,110,-1,35,13,40,-140,-99,9,39,-303,-255,-151,-100,-256,-280,-251,-263,ENTRY
-163,19,166,185,110,58,117,100,47,-25,-100,-163,52,30,-97,-116,14,-15,-83,-111,82,0,-85,-149,ENTRY
-103,38,109,147,81,149,64,109,45,-11,-77,-103,-87,-92,-90,-58,-33,-87,-170,-190,64,-39,-77,-136,ENTRY
60,61,65,126,58,125,151,35,-19,74,6,60,-71,37,36,41,-109,-79,-54,-11,-134,-9,-100,-49,ENTRY
-26,20,27,47,32,56,27,32,5,-8,-23,-26,58,3,12,-21,84,58,38,32,69,61,46,58,ENTRY
-49,26,49,75,47,32,56,27,-26,-27,-55,-49,-21,-35,-78,-75,32,-24,-43,-70,58,31,-17,-17,ENTRY
42,51,69,120,128,84,86,132,38,91,99,42,-10,100,64,80,-22,36,2,32,-139,-29,-17,20,ENTRY
-14,17,41,58,98,83,93,71,-30,-60,-20,-14,-67,-40,-15,-44,8,-58,-23,-81,52,8,21,-6,ENTRY
29,35,36,71,52,87,44,40,14,64,45,29,-19,19,35,43,4,30,3,10,18,51,20,33,ENTRY
5,11,11,22,99,41,46,32,94,12,89,5,70,69,88,99,72,47,71,75,93,82,92,77,ENTRY
8,12,31,43,22,99,41,46,5,28,7,8,99,40,96,13,75,97,95,107,77,75,78,83,ENTRY
14,26,2,28,43,22,99,41,8,-15,0,14,13,13,7,22,107,25,96,27,83,82,95,121,ENTRY
-152,4,152,156,77,58,58,42,15,-29,-108,-152,46,2,-96,-137,65,18,-80,-106,67,49,-65,-87,ENTRY
-69,29,82,111,48,97,73,124,-1,-27,-90,-69,-22,-65,-79,-70,-48,-51,-89,-91,52,-55,-42,-117,ENTRY
-21,20,77,97,73,124,66,35,-26,14,-10,-21,74,10,37,-47,59,90,59,53,54,100,38,38,ENTRY
18,34,7,41,103,143,115,51,68,-1,61,18,-35,-41,61,86,-147,-125,-51,-17,-168,-172,-162,-129,ENTRY
32,34,12,46,51,41,103,143,1,4,9,32,19,38,33,33,87,37,94,51,-16,-3,94,119,ENTRY
-21,18,33,51,14,23,29,22,-11,0,-37,-21,-8,-12,-40,-32,-11,-8,-30,-29,-21,-18,-47,-32,ENTRY
-25,0,25,25,51,14,23,29,-3,-15,11,-7,-14,-15,-26,-28,-11,-27,-29,-39,-14,-23,-19,-36,ENTRY
55,79,20,99,65,72,44,76,41,65,31,55,-24,46,19,96,-53,7,-48,31,-12,-1,-24,2,ENTRY
-28,38,34,72,41,50,88,115,28,-2,-33,-28,13,2,-20,0,-47,-54,-38,-15,63,-44,-1,-75,ENTRY
-62,13,76,89,72,41,50,88,-28,-20,-37,-62,0,-22,-70,-90,-15,-18,-57,-62,-75,-74,-75,-77,ENTRY
-101,47,116,163,97,134,111,129,-7,-18,-84,-101,103,-5,-34,-108,168,116,64,2,155,95,61,67,ENTRY
39,39,32,71,94,91,40,64,57,51,74,39,6,55,75,96,-3,43,12,45,30,48,41,36,ENTRY
166,166,0,166,150,41,44,35,-53,60,44,166,-61,82,-43,113,-38,85,-37,105,-30,114,-17,128,ENTRY
-47,4,47,51,41,59,60,112,-10,-28,-38,-47,-14,-26,-18,-57,30,-22,-13,-61,-53,-66,-5,-17,ENTRY
17,20,31,51,44,62,58,46,-2,30,23,17,-44,0,11,15,-43,-37,-30,-27,-5,4,-1,-26,ENTRY
-41,1,63,64,65,95,63,90,29,-14,-13,-41,83,23,54,-12,41,46,45,42,115,52,78,0,ENTRY
-55,4,83,87,64,65,95,63,-41,-35,-58,-55,-12,-49,-71,-96,42,-12,-4,-67,0,11,-13,-13,ENTRY
56,57,13,70,39,40,49,47,34,67,36,56,9,66,36,90,-12,43,22,65,-11,39,16,44,ENTRY
-62,9,73,82,78,106,90,75,-41,-46,-50,-62,13,-70,-46,-103,82,24,32,-49,35,30,23,20,ENTRY
-41,21,57,78,106,90,75,66,54,-24,4,-41,123,70,82,13,76,76,73,82,97,86,74,35,ENTRY
107,115,47,162,44,67,60,62,-10,144,26,107,-54,88,-7,97,-106,44,-58,53,-100,21,-79,1,ENTRY
-52,4,56,60,62,71,39,42,6,-23,-21,-52,64,8,19,-46,72,53,32,12,108,72,54,20,ENTRY
38,44,7,51,100,44,85,40,26,20,69,38,43,44,37,64,-30,3,37,81,-10,0,-11,8,ENTRY
57,59,11,70,34,45,39,65,15,61,25,57,-12,56,31,72,-17,37,6,45,-31,-4,-9,40,ENTRY
-27,1,32,33,42,40,53,88,-6,-15,-6,-27,-5,-11,-4,-33,29,-6,14,-32,-43,-38,17,2,ENTRY
-72,16,72,88,38,59,36,38,-26,-32,-82,-72,22,-26,-55,-98,13,12,-40,-50,7,7,-43,-59,ENTRY
14,18,23,41,24,55,38,50,1,35,18,14,-24,13,27,15,-53,-22,-25,-10,-21,-32,-23,-39,ENTRY
-36,27,36,63,35,83,67,76,-6,-21,-49,-36,87,47,67,22,69,33,37,51,88,37,50,33,ENTRY
-27,16,32,48,63,35,83,67,-36,-31,-16,-27,-42,-52,-65,-63,51,16,51,-5,33,2,21,24,ENTRY
85,85,0,85,59,99,65,69,31,79,53,85,-38,26,40,116,-25,41,21,47,-50,-9,-25,60,ENTRY
-12,11,12,23,39,47,41,27,-17,-18,-2,-12,23,-18,6,-29,43,8,26,11,59,38,42,31,ENTRY
-40,3,40,43,23,39,47,41,-12,-12,-32,-40,-29,-30,-34,-52,11,-30,-26,-69,31,-4,-6,-29,ENTRY
-18,10,35,45,34,42,50,103,-2,-8,-19,-18,3,-16,-19,-20,-19,-7,-2,-15,83,-2,56,-37,ENTRY
16,16,71,87,94,78,172,221,35,44,51,16,-11,62,53,51,-128,-66,19,5,-184,-198,-64,-112,ENTRY
-60,16,62,78,41,60,63,25,3,-16,-53,-60,47,-11,-29,-57,50,7,-8,-13,43,44,-9,-10,ENTRY
-31,47,55,102,76,156,62,64,-25,-15,-41,-31,113,-8,46,-56,109,105,65,82,126,93,55,78,ENTRY
26,33,14,47,30,33,37,35,-5,29,12,26,-4,26,12,21,-7,27,17,22,-13,1,-11,19,ENTRY
38,51,14,65,47,30,33,37,26,38,20,38,21,67,32,64,22,64,32,59,19,65,37,60,ENTRY
26,33,9,42,36,26,35,41,12,17,11,26,9,35,19,38,-15,11,4,35,-49,-18,-19,11,ENTRY
12,18,18,36,26,35,41,25,-3,18,8,12,-27,-6,-7,9,-61,-35,-30,-15,-56,-36,-47,-49,ENTRY
-24,0,25,25,15,20,11,23,4,-2,-12,-24,-6,-6,-11,-20,-3,-11,-25,-30,16,-6,-8,-27,ENTRY
-40,0,41,41,25,15,20,11,-24,-24,-40,-40,-20,-26,-52,-64,-30,-30,-51,-60,-27,-35,-65,-70,ENTRY
-24,5,45,50,41,60,53,29,-32,-19,-28,-24,18,-17,-7,-56,35,33,36,-6,51,45,24,11,ENTRY
-32,11,56,67,100,63,61,129,-19,-38,-5,-32,-24,-34,-38,-51,23,-10,-16,-56,73,14,76,-9,ENTRY
-125,21,125,146,80,69,118,170,-35,-58,-124,-125,-6,-56,-133,-160,24,-87,-115,-131,127,-32,-8,-101,ENTRY
-87,11,113,124,93,62,146,67,-24,-59,-90,-87,-26,-39,-101,-111,106,-6,16,-113,111,82,25,19,ENTRY
-21,18,27,45,56,55,123,51,-35,-37,-26,-21,-15,-61,-51,-56,53,-58,20,-36,24,19,25,32,ENTRY
-25,70,35,105,175,110,170,385,125,-30,40,-25,135,65,70,100,270,130,195,110,655,280,560,245,ENTRY
-110,5,130,135,105,175,110,170,-25,-15,-45,-110,100,-45,-5,-135,110,50,25,-10,245,115,150,0,ENTRY
70,70,15,85,90,155,85,100,20,40,45,70,-90,-10,60,90,-95,-25,-25,-20,-110,-80,-65,-25,ENTRY
20,45,45,90,155,85,100,90,-110,-50,15,20,-115,-65,-70,-90,-130,-120,-110,-95,-65,-65,-65,-110,ENTRY
45,45,25,70,60,95,30,50,20,35,25,45,-70,-5,20,65,-60,-10,-50,-25,-90,-30,-50,-15,ENTRY
-25,25,45,70,45,55,50,25,-45,-25,-50,-25,-15,-45,-60,-70,-35,-20,-40,-40,-55,-40,-85,-60,ENTRY
40,45,15,60,45,90,35,50,20,30,15,40,-60,-10,20,60,-40,-15,-40,-20,-60,-10,-20,0,ENTRY
5,40,0,40,60,45,90,35,40,-10,10,5,60,20,25,45,-20,-20,30,65,0,-25,-30,-15,ENTRY
-225,5,230,235,240,195,170,170,160,-75,-70,-225,235,45,5,-65,245,125,60,10,325,235,170,20,ENTRY
60,65,5,70,85,75,75,110,-10,15,30,60,-10,20,25,50,-10,-10,-5,50,-115,-50,-10,50,ENTRY
-105,5,105,110,120,85,55,120,90,-15,-5,-105,140,60,35,-15,110,95,40,35,60,40,50,5,ENTRY
60,100,0,100,65,40,35,35,10,60,25,60,20,55,-5,70,35,60,-5,80,25,70,5,95,ENTRY
-65,5,95,100,65,50,65,65,15,-5,-40,-65,-5,15,-35,-50,25,15,-20,-70,60,35,0,-40,ENTRY
10,40,40,80,90,85,65,85,40,35,45,10,-25,20,25,50,-35,-20,-35,-15,-90,-70,-65,-25,ENTRY
-75,15,105,120,20,25,70,55,0,15,-85,-75,-10,10,-85,-75,-5,-5,-55,-75,25,15,-50,-80,ENTRY
-60,0,70,70,70,40,40,40,-25,-55,-55,-60,-5,-25,-55,-85,5,-15,-45,-65,20,5,-25,-55,ENTRY
-150,25,150,175,155,110,105,80,60,-45,-65,-150,135,35,-30,-90,180,95,25,-15,160,115,20,30,ENTRY
15,25,25,50,110,130,65,75,75,10,70,15,-35,5,85,90,-40,0,15,-20,5,-5,20,-25,ENTRY
-100,50,105,155,100,55,90,80,-5,-70,-125,-100,35,-15,-115,-105,115,30,-35,-65,110,50,-25,15,ENTRY
80,80,10,90,80,105,65,40,-5,20,10,80,-35,25,40,75,-85,0,-25,45,-55,-5,-55,-5,ENTRY
-105,5,110,115,85,75,50,95,-20,-70,-100,-105,20,-50,-90,-125,25,10,-55,-85,85,20,0,-80,ENTRY
30,40,0,40,50,65,90,30,15,30,40,30,-45,-15,10,45,-80,-55,-5,-15,-65,-50,-60,-50,ENTRY
-40,50,80,130,50,60,190,125,-5,10,-70,-40,-10,5,-65,-45,85,-55,5,-50,70,10,5,45,ENTRY
50,55,5,60,40,50,50,60,-10,30,10,50,-35,20,10,40,-50,-20,-30,15,-85,-50,-50,0,ENTRY
30,35,30,65,80,65,115,50,-60,-5,10,30,-50,-20,-20,-30,-130,-85,-35,-20,-130,-100,-115,-100,ENTRY
-80,20,95,115,50,65,170,125,0,-15,-80,-80,-5,-10,-60,-80,105,-45,10,-85,65,75,85,25,ENTRY
70,70,45,115,240,130,60,40,-105,0,125,70,-25,-30,-15,-35,-25,65,10,45,-5,85,10,45,ENTRY
-20,25,25,50,90,35,50,30,-40,-35,5,-20,-30,-35,-50,-60,10,-35,-35,-50,30,5,-15,-10,ENTRY
25,30,10,40,55,50,35,40,15,35,50,25,-5,30,40,40,-10,10,5,20,30,25,25,15,ENTRY
50,65,5,70,90,60,85,105,5,5,25,50,10,30,20,55,-65,-10,5,60,25,-25,10,-15,ENTRY
-140,5,140,145,110,70,75,70,80,-30,-65,-140,130,70,-5,-60,115,90,20,-10,140,105,30,-25,ENTRY
90,90,15,105,80,85,65,65,10,85,60,90,-45,30,10,100,-30,45,5,45,-80,15,-25,60,ENTRY
-55,0,65,65,45,55,30,45,5,-20,-40,-55,-15,-30,-40,-50,-5,-10,-45,-70,0,-5,-25,-60,ENTRY
-35,5,35,40,25,40,25,40,5,-5,-20,-35,25,0,0,-30,30,15,0,-10,45,25,25,-5,ENTRY
50,85,35,120,100,80,85,85,-25,35,15,50,-65,-5,-45,25,-65,-15,-50,-15,-125,-60,-95,-15,ENTRY
-10,90,20,110,65,75,130,85,-10,-55,-100,-10,0,-40,-75,-20,90,-15,5,-10,135,70,45,80,ENTRY
30,45,40,85,100,75,75,50,0,-10,5,30,-35,5,-5,30,-65,-10,-20,-5,-95,-40,-75,-35,ENTRY
10,20,25,45,20,20,20,20,15,35,10,10,5,35,10,25,-5,20,-5,15,-15,15,-10,5,ENTRY
120,135,45,180,170,80,70,195,-100,65,55,120,-100,35,-65,20,-165,0,-110,20,-115,-135,-120,-45,ENTRY
-65,5,65,70,195,115,65,110,50,-135,-10,-65,130,20,65,-15,110,110,105,65,70,60,100,45,ENTRY
-15,5,20,25,25,50,60,20,5,5,5,-15,-5,-25,0,-10,30,-20,15,-20,25,15,10,15,ENTRY
30,30,25,55,40,95,45,40,-15,25,10,30,-55,0,40,15,-30,0,-10,-25,5,20,5,0,ENTRY
-15,15,20,35,20,35,45,55,-10,-15,-30,-15,0,-10,-10,-25,5,0,10,-15,55,10,30,-10,ENTRY
-50,35,55,90,45,35,20,35,10,-5,-50,-50,-5,-5,-60,-40,-15,-20,-90,-55,-5,-15,-70,-65,ENTRY
-175,0,175,175,60,70,120,110,-25,-35,-150,-175,35,-30,-135,-200,25,-25,-80,-140,55,10,-55,-150,ENTRY
45,45,55,100,105,115,70,85,-60,15,20,45,-170,-70,-55,-15,-175,-95,-125,-125,-170,-100,-115,-130,ENTRY
-165,5,170,175,115,105,130,70,40,-25,-85,-165,85,40,-30,-125,-10,-25,-70,-80,0,-5,-110,-175,ENTRY
65,65,0,65,30,55,30,40,-20,45,10,65,-50,0,-10,45,-45,0,-35,15,-15,20,-5,20,ENTRY
-55,230,60,290,355,560,205,650,-70,-310,-245,-55,285,-120,150,-125,435,235,150,230,865,225,585,380,ENTRY
20,30,30,60,55,65,50,75,20,20,15,20,-40,5,10,40,-65,-25,-35,-20,-5,-30,-15,-45,ENTRY
45,65,20,85,75,60,115,60,-15,35,25,45,0,45,20,30,-60,-30,0,45,-50,-15,-40,-15,ENTRY
-45,10,50,60,50,65,45,40,10,-20,-30,-45,45,5,10,-35,30,35,20,0,35,35,15,-15,ENTRY
40,40,25,65,55,60,125,40,-25,35,25,40,-15,5,0,15,-55,-40,20,25,-50,0,-25,-15,ENTRY
-50,70,80,150,50,130,80,95,5,-5,-105,-50,-65,-85,-105,-45,15,-35,-105,-115,-45,-20,-75,-35,ENTRY
10,35,20,55,95,90,80,105,35,25,65,10,0,25,60,45,5,-20,5,10,25,-10,40,15,ENTRY
15,20,30,50,35,70,60,40,-15,30,15,15,-80,-35,-15,0,-95,-75,-65,-65,-75,-55,-65,-80,ENTRY
-50,20,70,90,65,50,50,70,-25,-20,-45,-50,-10,-10,-50,-75,25,10,-30,-60,75,30,10,-25,ENTRY
115,125,15,140,180,190,205,95,175,130,170,115,10,120,170,290,-60,-65,0,125,-115,-5,-50,55,ENTRY
-55,20,75,95,110,265,205,65,-65,-80,-65,-55,140,-65,105,-120,0,10,120,85,-10,-35,-65,-55,ENTRY
-60,30,70,100,85,85,45,65,-60,-65,-80,-60,10,-65,-80,-120,-15,-10,-65,-50,5,-25,-60,-75,ENTRY
-65,25,65,90,60,90,40,85,-25,-50,-80,-65,25,-35,-35,-90,0,-10,-60,-40,45,-40,-45,-65,ENTRY
15,65,10,75,105,90,100,145,40,-5,25,15,20,10,25,55,40,35,60,35,-5,5,75,55,ENTRY
75,95,25,120,85,170,60,115,25,80,45,75,-115,-40,10,100,-110,-50,-110,-40,-25,-35,-40,-35,ENTRY
-140,5,165,170,60,115,80,235,5,-10,-120,-140,90,5,-50,-135,130,90,0,-50,-65,-80,-15,-10,ENTRY
-85,5,115,120,115,85,90,80,-20,-65,-70,-85,-10,-60,-95,-105,-50,-55,-85,-95,-30,-50,-90,-135,ENTRY
25,65,15,80,65,45,50,85,35,40,25,25,55,50,15,60,5,45,15,80,50,20,25,30,ENTRY
-145,0,155,155,115,175,120,155,40,-10,-50,-145,-50,-75,-55,-105,20,-50,-85,-195,95,-5,-5,-125,ENTRY
75,110,55,165,280,285,370,285,-225,-105,10,75,-290,-175,-55,-150,-115,-305,-100,-215,15,-45,75,-40,ENTRY
35,60,30,90,100,65,20,45,-35,15,25,35,-100,-35,-60,0,-80,-35,-105,-65,-75,-45,-90,-45,ENTRY
30,95,5,100,180,145,195,135,115,35,115,30,0,25,70,145,-90,-120,-25,30,-135,-130,-95,-60,ENTRY
-135,30,150,180,70,75,100,125,-60,-50,-160,-135,-20,-45,-150,-195,-35,-40,-120,-155,-60,-105,-160,-170,ENTRY
-20,15,30,45,55,50,60,215,20,-25,-15,-20,25,-10,-5,0,-15,-5,10,5,185,-15,155,-35,ENTRY
-10,10,15,25,45,55,50,60,-20,-25,-5,-10,0,-50,-20,-30,5,-35,-10,-10,-35,-30,5,-5,ENTRY
5,10,30,40,50,50,25,35,-5,0,10,5,30,30,40,0,30,55,40,35,-5,30,25,35,ENTRY
-45,10,65,75,115,55,75,90,5,-65,-25,-45,-30,-15,-35,-40,10,-20,-20,-75,85,25,40,-35,ENTRY
20,65,15,80,95,85,110,85,-20,-10,5,20,-80,-45,-40,0,-60,-70,-40,-60,-115,-95,-90,-40,ENTRY
85,105,5,110,110,105,195,80,65,90,90,85,65,90,85,150,-105,-30,55,150,-75,-25,-55,-20,ENTRY