F1,F2,F3,F4,F5,F6,F7,F8,F9,F10,F11,F12,F13,F14,F15,F16,F17,F18,F19,F20,F21,F22,F23,F24,label
-37,15,67,82,89,107,149,84,49,-5,2,-37,60,-2,23,12,197,81,148,23,194,224,226,160,SHORT
-11,19,36,55,44,67,76,64,2,17,6,-11,12,6,18,-9,52,35,56,1,23,47,56,41,SHORT
-31,22,31,53,55,44,67,76,-11,-36,-34,-31,-9,-19,-28,-42,1,-30,-16,-40,41,-1,22,-30,SHORT
82,85,1,86,37,37,52,54,-11,46,-3,82,-43,37,-12,71,3,40,6,39,-41,35,3,85,LONG
-13,8,15,23,38,33,42,45,-5,-15,0,-13,4,-9,1,-18,18,-4,15,-9,18,-6,16,5,SHORT
31,48,46,94,98,171,103,216,-4,16,20,31,-90,-18,59,27,-61,-43,-34,-59,-219,-181,-59,-30,LONG
99,106,45,151,94,98,171,103,31,98,41,99,27,114,61,130,-59,80,100,126,-30,55,7,40,LONG
199,216,6,222,91,93,162,123,-24,158,27,199,-14,156,27,175,-118,87,27,185,-86,25,-74,81,LONG
-26,49,27,76,69,132,218,222,3,-55,-62,-26,29,-93,-37,-23,207,-6,136,3,406,202,348,181,SHORT
3,13,56,69,132,218,222,91,26,-38,25,3,204,49,198,29,403,257,410,207,379,415,437,406,SHORT
-29,7,61,68,48,83,135,46,-8,-5,-25,-29,62,14,29,-37,178,88,155,33,141,169,147,149,SHORT
-94,59,99,158,67,77,37,67,-9,-16,-107,-94,14,-22,-103,-103,32,19,-102,-80,12,13,-78,-62,SHORT
62,76,3,79,70,67,65,115,-4,35,26,62,-5,18,6,58,48,49,35,57,-31,7,43,110,LONG
-105,2,120,122,189,45,67,66,145,-29,38,-105,149,148,71,40,186,154,99,44,239,201,145,81,SHORT
22,24,5,29,79,14,50,19,41,-6,44,22,35,55,40,63,-9,18,39,57,-24,-1,-11,13,LONG
-114,8,116,124,58,68,66,63,16,0,-66,-114,29,-25,-81,-98,45,-12,-70,-85,87,42,-19,-69,SHORT
17,33,18,51,68,46,90,83,36,27,44,17,7,42,37,53,-53,-20,19,24,-87,-85,-53,-36,LONG
36,44,4,48,35,57,63,56,5,16,3,36,-16,-6,3,41,-36,-32,-17,20,-55,-36,-28,0,LONG
12,26,3,29,46,40,30,34,-4,6,23,12,-2,-2,9,8,-12,-10,-9,10,-1,1,6,0,LONG
-27,9,53,62,63,54,76,79,28,0,1,-27,-7,15,7,1,33,13,27,-34,60,45,62,6,SHORT
15,27,5,32,62,63,54,76,-27,-33,-3,15,1,-33,-2,-12,-34,-18,4,16,6,-20,24,-19,SHORT
143,170,5,175,117,113,117,73,5,125,67,143,-62,54,-8,148,-83,65,7,81,-99,33,-69,60,LONG
-13,10,55,65,60,67,83,75,-24,-16,-21,-13,33,12,14,-37,49,53,71,20,48,71,81,36,SHORT
-13,15,15,30,59,32,31,40,42,-8,21,-13,71,41,43,29,91,69,70,58,69,66,76,78,SHORT
25,34,3,37,26,63,23,22,-10,18,7,25,-65,-38,-12,15,-80,-55,-69,-40,-80,-60,-75,-55,LONG
20,24,6,30,18,20,51,22,10,23,11,20,-6,20,10,30,23,8,29,14,5,29,21,43,LONG
-3,17,6,23,73,40,58,47,58,-7,43,-3,80,56,73,55,61,41,76,77,83,62,86,58,SHORT
-34,13,34,47,23,73,40,58,-3,-6,-30,-34,55,-13,13,-37,77,50,43,21,58,35,46,43,SHORT
56,59,4,63,35,27,31,37,24,58,30,56,-2,58,22,80,-32,27,-5,54,-53,6,-20,24,LONG
-201,47,201,248,126,112,36,71,91,-19,-141,-201,150,38,-98,-110,155,146,-66,-51,185,134,-43,-46,SHORT
114,130,10,140,91,178,80,130,-21,50,1,114,-92,-1,37,93,-74,-6,-66,22,-101,-46,-56,40,LONG
-100,4,100,104,100,91,106,46,65,-19,-23,-100,100,52,39,-35,158,90,92,0,176,139,81,58,SHORT
-60,4,92,96,78,83,104,63,3,-27,-45,-60,39,2,-11,-57,76,10,18,-21,100,77,44,16,SHORT
-8,77,9,86,30,60,66,67,-6,-11,-67,-8,23,-10,-36,-14,7,4,-16,15,61,2,-17,-1,SHORT
-50,9,67,76,86,30,60,66,-8,8,18,-50,-14,-3,-49,-58,15,-2,-18,-64,-1,12,2,-35,SHORT
3,9,24,33,58,96,79,55,38,24,49,3,-47,-26,37,41,-97,-79,-33,-44,-109,-122,-100,-94,LONG
5,13,20,33,41,39,60,88,-2,-11,-3,5,-13,-4,2,3,30,0,27,-8,89,28,83,35,SHORT
-29,0,50,50,33,41,39,60,5,1,-16,-29,3,-10,-19,-24,-8,-3,-14,-26,35,1,11,-37,SHORT
101,101,9,110,62,113,62,82,-38,71,23,101,-115,-16,-13,63,-118,-60,-108,-14,-156,-58,-86,-17,LONG
-61,26,63,89,55,61,107,126,-31,-44,-78,-61,3,-44,-72,-92,31,-6,12,-58,134,30,67,-30,SHORT
33,47,11,58,28,27,15,13,-5,38,8,33,-24,16,-15,28,-20,16,-27,9,-30,12,-33,13,LONG
-97,107,123,230,159,79,191,61,-43,-96,-167,-97,-81,-61,-212,-140,73,-60,-99,-178,117,88,-81,-24,SHORT
29,71,1,72,74,133,134,109,43,-1,1,29,19,34,95,72,-64,-38,24,48,-62,-118,-81,-35,LONG
-54,14,98,112,133,102,79,110,105,21,42,-54,20,59,49,51,43,18,-15,-34,-41,-1,-3,-11,SHORT
40,76,23,99,49,56,39,40,-18,23,-27,40,-60,-1,-44,22,-61,-25,-85,-20,-67,-31,-90,-21,LONG
-81,14,104,118,108,84,54,124,72,-4,-14,-81,26,37,3,-9,13,36,-28,-55,124,33,39,-68,SHORT
34,49,17,66,192,157,117,78,122,39,165,34,-4,33,124,156,-73,-52,-1,30,-141,-93,-81,-39,LONG
34,35,9,44,84,71,37,28,-69,-32,8,34,-92,-64,-37,-35,-112,-69,-76,-58,-118,-94,-110,-78,LONG
-76,4,76,80,24,42,63,27,1,-14,-70,-76,24,-18,-56,-75,56,3,-14,-52,59,50,-3,-20,SHORT
20,44,15,59,86,85,114,37,-38,-13,14,20,-22,-56,-30,-18,-90,-55,0,-2,-82,-75,-97,-70,LONG
-77,16,85,101,140,40,82,87,118,-11,28,-77,128,113,52,41,127,78,59,51,177,114,100,50,SHORT
48,48,12,60,77,69,60,77,-21,-17,0,48,-57,-28,-19,27,-112,-53,-53,-9,-174,-123,-106,-64,LONG
-41,14,100,114,89,64,90,60,-42,-1,-26,-41,4,17,-33,-83,81,60,36,-37,129,128,74,40,SHORT
123,123,13,136,137,84,83,114,-52,34,35,123,-44,33,-19,71,-107,12,-41,79,-148,-71,-93,16,LONG
76,84,6,90,101,117,43,37,84,67,78,76,-19,62,89,160,-2,44,-3,57,-15,45,-8,74,LONG
96,98,1,99,112,72,44,57,-85,0,13,96,-45,9,-18,11,-48,33,-22,51,-71,19,-23,48,LONG
-29,21,30,51,30,22,36,46,19,-6,-27,-29,38,20,-9,-10,39,23,8,9,65,24,19,10,SHORT
16,17,1,18,21,9,17,20,2,0,3,16,10,18,9,18,5,19,18,26,9,13,15,21,LONG
-28,11,42,53,27,38,44,29,9,4,-22,-28,24,21,6,-19,39,19,10,-4,39,41,17,11,SHORT
-53,21,57,78,121,122,123,40,74,-33,10,-53,163,45,89,21,71,55,100,110,55,37,-1,18,SHORT
75,75,8,83,46,70,83,44,-9,72,35,75,-50,33,20,66,-76,-13,-13,25,-70,-29,-68,-1,LONG
-17,24,19,43,91,60,64,71,45,-13,35,-17,70,36,53,28,111,63,84,53,136,113,141,94,SHORT
-82,12,89,101,43,91,60,64,-17,-12,-70,-82,28,-25,-35,-99,53,24,-17,-54,94,51,14,-29,SHORT
31,58,2,60,91,90,46,28,34,-12,19,31,-27,-22,8,65,-26,-14,-28,4,-42,-20,-52,5,LONG
-26,13,41,54,35,66,56,39,13,-1,-20,-26,-2,2,14,-13,24,4,6,-28,40,36,21,-2,SHORT
49,75,43,118,93,177,212,418,-8,33,8,49,-38,39,98,41,-26,-81,13,11,136,-146,154,23,LONG
-56,15,58,73,132,75,26,38,101,-26,33,-56,50,39,41,45,51,41,-6,-6,27,22,-13,-5,SHORT
67,113,26,139,85,129,75,114,-46,46,-8,67,-106,-37,-47,21,-102,-71,-135,-39,-140,-80,-105,-35,LONG
284,304,65,369,141,185,377,170,-53,271,43,284,-163,140,-44,231,-439,-93,-85,121,-368,-114,-313,-155,LONG
-173,188,176,364,95,62,80,115,17,-34,-303,-173,8,-3,-305,-156,26,-6,-290,-165,96,22,-227,-147,SHORT
42,89,26,115,231,364,95,62,-100,-50,66,42,-273,-208,41,-58,-256,-242,-262,-231,-265,-211,-264,-214,LONG
-95,12,112,124,179,179,115,231,161,-1,54,-95,122,28,83,66,164,113,104,27,64,63,170,69,SHORT
114,121,16,137,74,97,76,113,0,129,66,114,-8,89,49,114,-29,49,-12,106,-97,23,-1,85,LONG
-54,32,60,92,167,103,60,59,83,-71,4,-54,5,11,22,29,42,-9,-41,-49,19,10,-23,-12,SHORT
70,82,5,87,41,33,68,59,19,58,12,70,-6,65,11,89,-41,23,4,64,-92,-20,-48,29,LONG
-41,4,51,55,29,28,41,69,6,3,-23,-41,24,15,-12,-35,41,28,14,-17,86,32,46,0,SHORT
-50,2,88,90,62,73,95,123,-8,-22,-50,-50,13,-6,-23,-58,-30,-27,-22,-37,79,5,38,-80,SHORT
85,85,14,99,49,35,67,42,-1,85,35,85,-29,66,2,84,-9,67,35,56,-4,66,9,76,LONG
-66,24,72,96,61,79,160,120,11,-9,-44,-66,47,-1,-18,-55,131,34,98,-19,62,20,44,65,SHORT
40,64,33,97,207,115,64,98,-97,-26,84,40,-200,-127,-109,-57,-223,-175,-208,-160,-248,-236,-235,-183,LONG
-23,16,48,64,98,209,81,104,-25,-61,-27,-23,168,-16,129,-48,184,129,146,145,249,201,241,161,SHORT
16,17,64,81,104,74,71,67,65,72,95,16,10,84,77,81,-5,43,33,26,30,48,34,11,LONG
48,56,5,61,82,17,15,21,-67,-15,6,48,-77,-25,-69,-19,-74,-24,-70,-29,-82,-31,-71,-26,LONG
-24,10,30,40,40,35,33,14,22,-11,-11,-24,49,26,21,-2,66,39,32,25,66,65,39,42,SHORT
-29,9,31,40,29,35,39,47,9,-4,-15,-29,14,11,6,-20,-1,0,-1,-15,-8,-15,-8,-30,SHORT
15,15,6,21,13,24,29,23,-5,8,0,15,-3,15,18,10,-14,-4,4,12,-25,-9,-7,1,LONG
-30,3,38,41,66,66,55,73,-36,-28,-3,-30,2,-28,-3,-66,39,-8,6,-28,103,46,78,9,SHORT
-41,8,41,49,54,24,46,31,29,-23,-18,-41,43,28,3,-12,19,9,6,2,35,13,-5,-22,SHORT
56,57,11,68,46,38,46,33,-25,26,4,56,12,42,12,31,-32,34,12,68,-54,9,-26,24,LONG
-25,33,25,58,62,52,149,48,14,-19,-15,-25,8,-36,-42,-11,52,2,93,-17,95,52,42,27,SHORT
43,48,0,48,80,82,48,90,31,43,75,43,0,33,67,74,3,33,33,43,-77,-35,7,46,LONG
102,102,4,106,39,114,159,105,-8,77,10,102,-46,34,42,94,73,42,95,56,-25,75,74,175,LONG
-15,7,15,22,40,22,35,21,31,-6,12,-15,18,15,15,16,35,11,24,3,49,31,30,20,SHORT
-4,16,13,29,22,40,22,35,-15,-6,-13,-4,16,-12,-1,-19,3,9,2,12,20,5,11,-1,SHORT
-13,3,38,41,29,22,40,22,-4,12,0,-13,-19,6,-13,-17,12,0,-1,-32,-1,21,2,-1,SHORT
94,112,5,117,102,56,56,91,-55,44,29,94,-56,13,-48,39,-77,2,-59,38,-153,-60,-86,17,LONG
30,34,5,39,54,31,43,37,-38,-8,7,30,-62,-29,-37,-8,-70,-47,-43,-32,-59,-42,-44,-40,LONG
-16,19,80,99,137,81,172,66,110,49,87,-16,150,149,131,94,186,179,252,134,207,218,185,170,SHORT
-31,64,78,142,99,137,81,172,-16,-33,-76,-31,94,16,11,-47,134,116,55,63,170,146,176,103,SHORT
23,53,37,90,44,90,133,67,-16,29,-17,23,-49,7,7,7,-128,-100,-57,-26,-176,-120,-143,-105,LONG
26,50,8,58,90,44,90,133,23,-3,29,26,7,26,12,49,-26,4,36,33,-105,-103,-28,0,LONG
49,54,3,57,37,49,46,52,-18,27,7,49,-35,3,-5,31,-46,-19,-30,14,-15,0,-5,3,LONG
-82,0,99,99,91,107,67,73,48,0,-8,-82,37,34,42,-34,38,44,12,-45,89,33,7,-44,SHORT
-24,11,37,48,37,80,65,37,5,-17,-28,-24,35,-1,31,-19,76,40,57,11,86,67,56,52,SHORT
48,52,21,73,57,71,48,37,-27,26,10,48,-86,-19,-21,21,-110,-54,-79,-38,-105,-71,-107,-62,LONG
-86,9,92,101,107,147,99,145,82,-19,-13,-86,225,85,131,-4,299,219,217,139,202,173,217,213,SHORT
-21,10,48,58,58,49,57,47,36,18,18,-21,50,48,39,15,89,66,65,29,111,109,98,68,SHORT
-16,13,39,52,58,58,49,57,-21,-25,-19,-16,15,-7,-1,-37,29,23,20,-1,68,41,46,13,SHORT
2,29,16,45,65,100,77,70,-50,-34,-14,2,7,-43,12,-48,-31,-29,3,9,-24,-58,-33,-29,LONG
6,23,19,42,45,65,100,77,2,9,12,6,-48,-25,-2,8,9,-34,24,-42,-29,-20,15,15,LONG
6,29,14,43,42,45,65,100,6,1,0,6,8,10,12,12,-42,-24,-2,14,15,-33,24,-36,LONG
7,19,9,28,101,18,13,35,-51,-39,34,7,-52,-47,-57,-44,-54,-44,-59,-45,-77,-64,-57,-47,LONG
19,31,9,40,28,101,18,13,7,19,7,19,-44,-20,41,26,-45,-28,-50,-25,-47,-25,-52,-26,LONG
-29,0,43,43,67,44,63,34,46,-4,20,-29,57,40,41,17,90,68,88,28,78,79,70,61,SHORT
-36,1,64,65,43,67,44,63,-29,-15,-37,-36,17,-19,-17,-65,28,25,4,-19,61,53,51,-8,SHORT
-29,0,34,34,30,10,28,13,20,-3,-7,-29,20,18,-6,-9,41,18,12,-9,38,34,13,12,SHORT
-56,3,66,69,34,30,10,28,-29,-24,-59,-56,-9,-27,-66,-85,-9,-6,-65,-65,12,-6,-47,-65,SHORT
-27,16,27,43,32,16,27,63,12,-15,-26,-27,13,5,-22,-15,21,-4,-20,-14,74,11,31,-6,SHORT
-20,0,26,26,43,32,16,27,-27,-21,-4,-20,-15,-36,-30,-47,-14,-16,-26,-35,-6,-25,-24,-34,SHORT
81,86,1,87,65,81,46,163,-30,32,10,81,-111,-29,-35,51,-103,-53,-94,-30,50,-24,52,-22,LONG
-26,13,61,74,71,115,86,53,52,16,13,-26,113,57,98,26,76,90,102,87,87,92,71,50,SHORT
-17,9,50,59,74,71,115,86,-26,-28,-13,-17,26,-12,0,-43,87,29,85,9,50,62,89,70,SHORT
-60,9,69,78,44,26,46,46,-26,-31,-65,-60,-16,-20,-72,-86,-10,-30,-62,-76,8,-3,-35,-70,SHORT
99,99,9,108,74,80,78,44,-26,55,21,99,-69,9,-19,73,-129,-30,-60,30,-155,-61,-125,-30,LONG
48,54,5,59,51,18,32,73,-27,22,14,48,-21,20,-21,21,-39,0,-27,27,-96,-58,-44,9,LONG
-9,7,26,33,42,30,59,51,36,17,26,-9,38,37,34,27,86,50,76,29,59,72,90,77,SHORT
-11,12,28,40,33,42,30,59,-9,-9,-16,-11,27,8,10,-20,29,28,18,16,77,41,60,18,SHORT
-13,11,19,30,52,20,25,23,32,5,27,-13,44,33,23,19,53,42,37,31,40,36,29,40,SHORT
-46,1,49,50,30,52,20,25,-13,-16,-36,-46,19,-11,-9,-59,31,17,-13,-27,40,26,1,-15,SHORT
-96,32,106,138,80,80,44,124,37,-1,-59,-96,107,37,-21,-59,103,106,12,11,46,54,40,7,SHORT
8,15,38,53,42,56,48,70,-16,14,3,8,-65,-21,-18,-8,-77,-39,-44,-57,-24,-44,-27,-69,LONG
83,87,2,89,53,42,56,48,8,47,11,83,-8,61,14,91,-57,26,-7,75,-69,8,-33,26,LONG
61,76,13,89,65,57,26,41,-39,12,-12,61,-90,-18,-50,22,-83,-22,-85,-29,-56,-21,-69,-22,LONG
28,45,10,55,89,65,57,26,61,25,59,28,22,37,47,89,-29,7,9,50,-22,3,-26,-1,LONG
33,41,19,60,66,40,15,35,-31,12,18,33,-41,-16,-36,2,-31,11,-34,-8,-52,-4,-29,2,LONG
19,43,9,52,60,66,40,15,33,9,17,19,2,21,35,52,-8,-7,-19,21,2,20,-17,11,LONG
-11,10,15,25,36,39,56,39,2,-10,1,-11,13,-1,13,-9,48,10,41,2,65,48,62,37,SHORT
-7,15,10,25,29,22,25,36,-8,-14,-10,-7,5,-7,-10,-15,-6,-7,-7,-2,-4,-17,-6,-13,SHORT
37,42,13,55,56,61,163,89,-48,2,3,37,-44,-13,-7,-11,-139,-101,7,-7,-100,-124,-90,-102,LONG
25,38,12,50,55,56,61,163,37,24,29,25,-11,26,32,62,-7,11,22,14,-102,-77,36,18,LONG
-6,26,9,35,41,55,72,104,30,-2,4,-6,21,4,24,24,74,21,58,15,144,53,122,68,SHORT
-15,35,21,56,35,41,55,72,-6,-3,-24,-15,24,-5,-20,-21,15,1,0,9,68,18,34,0,SHORT
-52,4,62,66,47,56,35,41,15,9,-10,-52,0,4,-6,-37,-6,1,-30,-52,24,-1,-26,-58,SHORT
6,36,14,50,50,96,161,110,0,5,5,6,39,12,58,6,-62,-95,16,45,-166,-148,-88,-56,LONG
71,91,16,107,50,50,96,161,6,73,16,71,6,78,21,77,45,85,74,77,-56,-22,32,116,LONG
-1,18,12,30,61,22,39,29,15,-28,3,-1,7,15,7,14,-3,-17,-8,6,-3,-7,-8,-4,SHORT
-16,7,18,25,30,61,22,39,-1,-10,-5,-16,14,-38,-2,-17,6,5,2,-2,-4,-27,-13,-10,SHORT
-60,16,61,77,25,30,61,22,-16,-17,-69,-60,-17,-27,-74,-76,-2,-55,-71,-77,-10,-12,-67,-62,SHORT
-30,24,38,62,43,49,50,41,20,0,-19,-30,53,12,-1,-10,20,11,-1,23,-3,-6,-27,-10,SHORT
-34,26,50,76,62,43,49,50,-30,-22,-36,-34,-10,-22,-55,-64,23,-10,-37,-44,-10,-11,-37,-11,SHORT
-10,31,87,118,57,68,54,61,11,51,-10,-10,-25,51,1,1,15,42,-22,-35,27,60,3,5,SHORT
-30,4,102,106,118,57,68,54,-10,-15,-3,-30,1,36,-13,-40,-35,36,-2,-29,5,27,-25,-65,SHORT
-98,7,110,117,130,70,70,101,58,-9,4,-98,90,33,-14,-40,98,79,32,-8,178,102,86,0,SHORT
16,53,17,70,205,89,62,104,125,-10,125,16,60,93,112,141,78,61,53,76,14,44,78,94,LONG
41,41,24,65,121,78,199,172,-86,-28,28,41,-130,-72,-59,-45,12,-116,18,-89,178,77,184,53,LONG
8,8,54,62,65,121,78,199,41,38,41,8,-45,10,69,49,-89,-34,-18,-37,53,-78,59,-81,LONG
-9,1,15,16,33,23,38,13,-14,-20,-3,-9,-9,-17,-10,-23,14,-11,11,-18,22,20,17,5,SHORT
-9,17,34,51,27,40,35,23,15,14,-10,-9,42,30,19,6,17,32,16,33,7,23,-5,8,SHORT
-40,18,42,60,51,27,40,35,-9,-32,-41,-40,6,-18,-51,-49,33,-2,-22,-34,8,0,-25,-7,SHORT
64,64,4,68,35,37,69,48,-18,42,9,64,-10,36,5,46,-55,-5,-4,54,-78,-23,-43,9,LONG
-2,9,16,25,47,28,68,35,29,0,22,-2,44,37,40,27,108,54,97,42,90,96,106,106,SHORT
-15,11,15,26,25,47,28,68,-2,-16,-17,-15,27,-16,5,-17,42,21,23,12,106,38,80,27,SHORT
14,25,9,34,31,44,35,36,-11,3,0,14,-53,-30,-20,3,-33,-35,-34,-39,-59,-42,-40,-19,LONG
24,59,0,59,34,31,44,35,14,15,-10,24,3,18,-10,38,-39,-15,-30,27,-19,-20,-44,-15,LONG
-41,23,41,64,105,67,65,60,104,-1,40,-41,61,49,52,63,116,61,62,20,146,99,95,75,SHORT
-49,28,59,87,111,135,96,144,46,-14,10,-49,106,-13,35,-3,159,97,106,57,221,154,211,110,SHORT
-18,18,27,45,47,44,92,50,31,-7,-5,-18,45,19,18,13,80,21,68,27,80,61,66,62,SHORT
-36,8,47,55,45,47,44,92,-18,-16,-26,-36,13,-23,-31,-54,27,3,-8,-23,62,5,42,-9,SHORT
-7,58,7,65,37,37,50,72,-26,-29,-57,-7,-2,-27,-55,-33,-21,-21,-36,-9,-17,-62,-55,-28,SHORT
-6,19,16,35,65,37,37,50,-7,3,33,-6,-33,-26,-24,-13,-9,-24,-22,-39,-28,-18,-3,-15,SHORT
-3,35,9,44,93,114,98,47,56,4,53,-3,-23,-46,24,53,-105,-99,-45,-26,-107,-118,-115,-108,LONG
21,30,5,35,44,93,114,98,-3,17,26,21,53,21,79,18,-26,-29,50,74,-108,-82,-19,-5,LONG
-43,56,44,100,71,67,68,125,36,-16,-45,-43,78,13,-20,-7,52,51,19,35,91,-5,20,9,SHORT
-31,27,36,63,100,71,67,68,-43,-39,-2,-31,-7,-55,-47,-74,35,-26,-22,-38,9,12,17,4,SHORT
-47,25,47,72,48,47,26,36,0,-11,-35,-47,39,-2,-27,-47,54,33,-13,-8,57,50,14,7,SHORT
15,20,6,26,36,27,23,36,3,17,27,15,18,21,22,18,-3,16,13,33,-3,4,14,12,LONG
19,20,17,37,32,76,81,78,4,29,24,19,-44,-33,6,23,-55,-40,4,-25,-11,-31,10,-36,LONG
27,30,5,35,37,32,76,81,19,15,17,27,23,44,41,46,-25,-18,23,50,-36,-25,21,2,LONG
-10,64,16,80,111,124,116,76,11,-34,-3,-10,101,-12,32,1,34,8,44,91,7,-1,-5,24,SHORT
-115,3,253,256,80,111,124,116,-10,122,-54,-115,1,88,-57,-125,91,110,-22,-114,24,130,-10,-24,SHORT
-17,19,55,74,91,81,51,74,65,22,39,-17,90,47,54,48,93,99,76,73,89,126,126,76,SHORT
-115,11,131,142,74,91,81,51,-17,-39,-107,-115,48,-17,-68,-132,73,8,-53,-67,76,60,-31,-42,SHORT
130,163,9,172,113,88,34,93,-77,27,-32,130,-162,-23,-107,53,-166,-36,-174,-32,-245,-117,-196,-36,LONG
188,221,23,244,172,113,88,34,130,202,130,188,53,229,98,318,-32,179,23,241,-36,166,-44,156,LONG
-79,3,90,93,43,65,70,96,9,-20,-70,-79,30,-15,-43,-70,21,20,-3,-49,-52,-55,-52,-58,SHORT
-4,21,13,34,93,43,65,70,-79,-81,-22,-4,-70,-101,-92,-83,-49,-96,-65,-74,-58,-61,-25,-53,SHORT
45,46,8,54,78,70,48,66,-19,5,29,45,-6,32,48,26,-46,2,-4,39,-88,-57,-45,-1,LONG
45,62,12,74,54,78,70,48,45,49,29,45,26,54,58,90,39,81,77,71,-1,51,25,84,LONG
-9,18,19,37,45,41,17,51,-21,-28,-20,-9,12,-13,-9,-30,24,17,-3,3,75,34,48,15,SHORT
-12,8,27,35,37,45,41,17,-9,-4,-2,-12,-30,-32,-22,-21,3,-17,-11,-42,15,13,-5,-9,SHORT
-5,12,28,40,35,37,45,41,-12,-4,-9,-5,-21,-8,-11,-17,-42,-36,-31,-26,-9,-21,-20,-47,SHORT
236,274,19,293,142,538,58,42,-57,159,8,236,-440,-187,58,179,-460,-217,-452,-204,-460,-214,-465,-224,LONG
6,36,26,62,88,113,115,189,23,-3,23,6,-73,-56,-5,29,-82,-147,-94,-67,-83,-158,-31,-76,LONG
35,39,7,46,77,62,88,113,41,25,56,35,47,57,73,76,70,54,96,82,-26,1,68,105,LONG
41,60,17,77,62,88,113,115,6,32,17,41,29,29,40,47,-67,-24,12,70,-76,-115,-77,-26,LONG
-13,6,21,27,38,41,39,41,20,-10,1,-13,3,2,16,7,33,7,19,-10,44,37,51,20,SHORT
-42,3,44,47,27,38,41,39,-13,-19,-39,-42,7,-29,-38,-55,-10,-17,-23,-35,20,-12,-20,-52,SHORT
-20,26,32,58,42,47,27,38,0,3,-13,-20,-42,-32,-43,-20,-55,-51,-82,-62,-35,-61,-81,-75,SHORT
0,33,9,42,47,27,38,41,-42,-35,-30,0,-55,-54,-69,-42,-35,-64,-68,-55,-52,-52,-53,-35,SHORT
95,95,1,96,54,51,33,27,-14,53,11,95,-22,60,15,81,-35,51,-12,73,-32,55,-14,60,LONG
50,60,19,79,96,54,51,33,95,68,85,50,81,121,96,145,73,128,100,131,60,119,73,123,LONG
50,50,26,76,138,66,76,21,-91,-36,26,50,-54,-15,-25,-41,-130,-54,-54,-4,-133,-65,-120,-80,LONG
43,51,1,52,76,138,66,76,50,18,42,43,-41,-18,68,93,-4,3,17,2,-80,-36,-12,39,LONG
-34,11,45,56,98,73,56,63,-1,-20,22,-34,40,3,20,-35,55,41,41,6,65,54,61,21,SHORT
-23,2,56,58,56,98,73,56,-34,-12,-14,-23,-35,-32,8,-57,6,-9,6,-58,21,29,27,-17,SHORT
-2,73,36,109,398,53,48,37,201,-59,230,-2,199,211,155,199,202,224,163,197,196,221,149,200,SHORT
-130,5,168,173,109,398,53,48,-2,2,-62,-130,199,-57,168,-132,197,213,93,69,200,226,101,67,SHORT
129,137,28,165,164,65,180,140,-122,29,28,129,-168,-21,-121,7,-215,-179,-164,-39,-194,-87,-112,-86,LONG
51,93,0,93,165,164,65,180,129,23,95,51,7,52,123,180,-39,2,-26,58,-86,-156,-69,12,LONG
33,34,36,70,90,149,104,102,-66,-1,19,33,-187,-126,-47,-33,-139,-141,-107,-154,-118,-131,-99,-106,LONG
44,54,17,71,70,90,149,104,33,25,24,44,-33,24,43,77,-154,-101,-23,11,-106,-116,-83,-110,LONG
-12,4,34,38,74,86,52,37,-47,-45,-9,-12,20,-37,11,-59,14,-5,9,8,22,15,14,2,SHORT
-74,0,77,77,38,74,86,52,-12,-31,-70,-74,-59,-76,-79,-86,8,-68,-59,-133,2,-36,-61,-66,SHORT
27,31,5,36,40,32,27,48,-26,2,6,27,-46,-18,-22,1,-62,-30,-39,-19,-16,-31,-19,-35,LONG
15,54,11,65,36,40,32,27,27,21,-8,15,1,23,-2,42,-19,3,-30,16,-35,-9,-47,-4,LONG
-23,4,27,31,34,29,28,51,24,-6,-3,-23,44,22,20,1,62,39,36,21,54,36,56,39,SHORT
50,51,7,58,40,65,52,50,15,53,35,50,-18,22,29,65,0,27,21,32,-3,25,17,50,LONG
-10,76,24,100,122,53,44,62,64,-27,-5,-10,92,78,31,54,91,86,30,82,63,69,31,81,SHORT
-34,36,57,93,100,122,53,44,-10,-1,6,-34,54,-28,1,-44,82,77,37,20,81,85,36,48,SHORT
48,92,5,97,56,52,60,26,-6,26,-15,48,-9,32,-13,42,-43,7,-30,39,-28,1,-70,5,LONG
37,41,3,44,35,33,30,71,-14,23,14,37,-15,2,-9,23,-20,3,-11,22,-81,-42,-15,17,LONG
18,18,12,30,26,30,44,35,-9,18,14,18,-8,6,6,9,29,19,33,10,15,42,47,47,LONG
29,34,16,50,22,27,16,54,6,35,7,29,-10,30,7,35,-15,26,-8,19,0,9,13,14,LONG
-36,17,40,57,34,17,29,27,10,-12,-35,-36,19,7,-33,-26,35,13,-15,-17,51,39,9,-1,SHORT
-15,10,15,25,30,32,57,34,11,-15,-10,-15,4,-14,-7,-4,-32,-36,-4,-11,-22,-48,-39,-47,SHORT
21,26,9,35,50,59,33,40,3,6,21,21,-33,-21,3,24,-42,-34,-36,-12,-41,-31,-26,-21,LONG
10,24,16,40,45,35,50,59,-8,13,18,10,13,9,4,2,16,15,25,23,-20,-12,7,26,LONG
-28,10,116,126,90,67,92,81,-32,1,-35,-28,23,44,-15,-60,2,26,-8,-5,70,87,42,-26,SHORT
-9,16,29,45,86,61,90,96,33,-15,26,-9,33,45,61,24,49,33,78,24,-9,7,58,40,SHORT
-13,31,25,56,45,86,61,90,-9,-17,-28,-13,24,-32,-2,-22,24,28,33,11,40,16,50,11,SHORT
-3,12,26,38,44,36,26,37,-9,-18,-12,-3,-12,-7,-9,-12,-10,-8,-20,-15,-23,-18,-19,-13,SHORT
-11,23,12,35,91,62,66,82,69,-7,49,-11,75,30,57,58,107,42,73,64,83,30,77,96,SHORT
-5,23,14,37,35,91,62,66,-11,-3,-5,-5,58,-10,44,-16,64,27,52,53,96,39,68,59,SHORT
-33,18,45,63,37,35,91,62,-5,-2,-28,-33,-16,-5,-33,-38,53,-12,16,-49,59,25,24,20,SHORT
38,42,20,62,96,69,95,98,-65,-29,5,38,-94,-47,-40,-27,-136,-115,-82,-56,-63,-101,-65,-98,LONG
75,79,1,80,62,96,69,95,38,56,38,75,-27,27,43,113,-56,9,-2,48,-98,-59,-44,19,LONG
-132,10,158,168,121,130,60,77,93,10,-37,-132,202,117,79,-39,153,168,60,70,210,179,88,21,SHORT
-86,21,103,124,168,121,130,60,-132,-141,-97,-86,-39,-131,-134,-218,70,-24,-18,-125,21,27,-37,-16,SHORT
86,97,20,117,69,99,47,48,-10,59,11,86,-86,8,-10,76,-80,-1,-71,0,-111,-8,-77,6,LONG
-31,14,34,48,73,59,81,78,0,-42,-17,-31,10,-16,-5,-31,37,-22,11,-21,59,2,32,6,SHORT
67,67,3,70,135,45,63,93,-68,-52,13,67,-44,-8,-33,-1,-84,-24,-31,23,-138,-74,-51,-17,LONG
75,77,0,77,70,135,45,63,67,72,65,75,-1,20,78,142,23,64,32,74,-17,48,34,98,LONG
-20,7,20,27,16,28,28,31,-10,-16,-27,-20,11,-10,-9,-30,20,2,3,-9,30,4,8,0,SHORT
-16,34,25,59,43,36,31,61,-33,-25,-41,-16,0,-27,-50,-49,-9,-5,-33,-16,-53,-44,-42,-25,SHORT
-11,9,18,27,60,62,36,49,-32,-33,0,-11,-4,-30,5,-43,-4,-30,-21,-15,17,-11,11,-15,SHORT
-41,1,44,45,48,59,36,79,-9,-39,-36,-41,25,-30,-16,-50,14,5,-4,-16,82,17,51,-27,SHORT
91,101,5,106,82,68,80,72,-19,51,27,91,-38,53,15,72,-77,-5,-31,53,-62,-36,-70,14,LONG
76,92,23,115,70,102,45,106,-20,62,17,76,-66,-2,-15,56,-72,12,-58,10,19,22,13,4,LONG
-54,12,54,66,62,81,67,62,23,-35,-39,-54,30,-16,-1,-31,45,14,15,-24,48,5,1,-9,SHORT
-126,26,138,164,83,66,62,81,11,-14,-95,-126,-43,-31,-129,-115,-20,-66,-168,-169,-13,-47,-130,-146,SHORT
16,17,9,26,30,58,25,17,-13,2,6,16,-55,-36,-4,3,-35,-34,-35,-39,-31,-23,-32,-19,LONG
18,20,8,28,26,30,58,25,16,17,15,18,3,19,21,34,-39,-19,11,21,-19,-17,-20,-21,LONG
9,20,51,71,57,92,56,31,17,47,33,9,-54,6,27,26,-109,-50,-65,-45,-108,-69,-109,-100,LONG
-57,14,57,71,45,52,26,43,14,-22,-48,-57,56,9,-10,-43,51,50,5,-1,15,14,-14,-6,SHORT
-21,18,31,49,71,45,52,26,-57,-47,-25,-21,-43,-69,-73,-78,-1,-38,-35,-64,-6,3,-20,-22,SHORT
-20,17,25,42,38,48,62,65,13,-14,-18,-20,59,16,22,-7,96,49,69,39,57,59,82,76,SHORT
-49,10,57,67,19,44,25,26,2,6,-42,-49,27,-8,-31,-47,17,17,-25,-22,25,11,-30,-32,SHORT
4,10,21,31,34,44,55,43,15,21,24,4,-5,11,24,19,-34,-14,10,-1,-23,-23,-11,-30,LONG
-15,26,15,41,17,18,24,15,-3,-13,-37,-15,-11,-12,-35,-18,23,2,-15,-11,29,15,-11,8,SHORT
-144,18,149,167,146,148,175,145,-107,-141,-162,-144,25,-113,-132,-251,91,-62,-54,-119,87,62,40,-53,SHORT
66,83,92,175,145,328,80,77,-4,124,94,66,-158,-43,110,62,-135,-22,-117,-92,-103,-22,-120,-69,LONG
-10,13,30,43,93,55,45,56,-75,-55,-5,-10,-20,-55,-43,-85,-35,-34,-32,-30,1,-26,-13,-45,SHORT
45,88,10,98,87,206,122,163,20,18,7,45,-25,-104,4,65,37,1,25,20,138,36,101,82,LONG
91,115,74,189,171,122,91,60,-32,77,59,91,-133,21,-46,59,-212,-47,-145,-42,-159,-52,-181,-121,LONG
60,71,36,107,189,171,122,91,91,22,104,60,59,99,163,151,-42,43,58,119,-121,-25,-41,18,LONG
-101,10,112,122,91,60,51,70,-79,-68,-99,-101,-26,-73,-135,-180,-68,-65,-136,-127,-27,-85,-137,-169,SHORT
75,76,1,77,136,135,69,83,-93,-48,11,75,-219,-149,-91,-18,-212,-162,-170,-144,-160,-149,-143,-137,LONG
50,58,19,77,77,77,136,135,-9,42,42,50,66,59,59,41,-27,11,70,116,-153,-90,-32,23,LONG
-126,3,132,135,69,83,70,73,7,-13,-79,-126,59,0,-52,-119,50,39,-26,-67,79,22,-40,-76,SHORT
-23,4,24,28,22,30,23,39,-2,-2,-8,-23,10,-16,-14,-25,26,8,3,-13,48,11,22,3,SHORT
25,51,36,87,44,108,65,142,17,46,3,25,-74,-29,-8,42,-54,-33,-55,-49,-147,-103,-48,-29,LONG
78,83,9,92,87,44,108,65,25,51,46,78,42,97,49,103,-49,22,38,120,-29,18,-9,29,LONG
-93,32,110,142,148,119,90,91,-125,-125,-119,-93,-28,-129,-152,-218,-50,-55,-107,-121,-86,-97,-148,-143,SHORT
-73,21,108,129,200,58,86,70,130,-30,41,-73,150,149,78,57,182,155,112,77,137,154,95,109,SHORT
-284,0,288,288,129,200,58,86,-73,-104,-263,-284,57,-134,-222,-357,77,45,-185,-227,109,51,-151,-207,SHORT
93,121,14,135,105,69,93,65,35,37,7,93,-18,84,18,128,-73,25,-17,75,-35,11,-59,20,LONG
35,35,70,105,69,93,65,114,-53,47,11,35,-108,-12,-24,-18,-70,-26,-66,-73,-146,-70,-61,-35,LONG
-38,8,40,48,30,62,33,49,-9,-11,-29,-38,35,-13,1,-47,36,24,9,-3,56,23,24,-2,SHORT
5,11,13,24,30,31,28,51,8,2,8,5,6,19,26,13,-6,2,6,11,11,-1,26,-1,LONG
15,19,15,34,24,30,31,28,5,17,7,15,13,19,15,20,11,36,33,28,-1,19,13,26,LONG
59,104,0,104,175,113,46,88,-76,-67,4,59,-171,-112,-103,-17,-165,-150,-208,-112,-106,-132,-148,-106,LONG
71,99,6,105,104,175,113,46,59,77,76,71,-17,10,80,130,-112,-35,-27,54,-106,-73,-132,-41,LONG
-95,18,95,113,46,88,43,57,6,-38,-105,-95,65,-20,-45,-89,78,50,-20,-30,85,39,-17,-17,SHORT
7,18,39,57,66,80,208,57,-18,28,37,7,-55,-40,-17,-11,-175,-139,12,-48,-220,-177,-177,-168,LONG
-120,78,130,208,57,28,20,45,-45,-38,-189,-120,-26,-43,-223,-165,-18,-23,-211,-146,-33,-35,-198,-138,SHORT
-69,5,74,79,26,40,23,47,14,-5,-58,-69,-9,-16,-55,-55,0,-14,-70,-78,-19,-34,-66,-69,SHORT
-31,12,43,55,31,59,139,62,0,-3,-27,-31,51,9,13,-31,-10,-10,74,20,-31,-24,-17,-41,SHORT
-31,6,48,54,47,48,50,45,-32,-23,-30,-31,4,-22,-28,-63,32,0,-4,-27,29,27,18,1,SHORT
55,70,6,76,46,24,19,43,-3,42,12,55,7,49,-3,52,7,59,2,62,-17,44,11,62,LONG
17,21,31,52,55,70,176,202,-14,6,9,17,-23,-18,0,3,-98,-118,6,-6,-273,-246,-96,-81,LONG
-31,4,50,54,50,74,92,52,-12,-7,-11,-31,55,3,23,-43,128,55,93,24,145,116,114,97,SHORT
52,52,22,74,54,50,74,92,-31,24,4,52,-43,17,-7,21,24,27,27,9,97,79,97,76,LONG
88,93,10,103,67,80,42,52,58,97,61,88,-22,76,53,146,-9,76,15,66,-38,59,8,79,LONG
-248,4,265,269,78,45,61,148,31,0,-191,-248,29,30,-194,-217,31,44,-164,-219,111,-15,-136,-217,SHORT
17,28,7,35,62,39,54,35,32,23,50,17,14,20,24,49,29,34,53,31,19,24,24,46,LONG
-26,21,37,58,56,37,63,34,-40,-37,-39,-26,-31,-32,-53,-66,0,-45,-40,-57,-26,-22,-46,-26,SHORT
40,40,26,66,120,39,27,34,-95,-33,21,40,-68,-31,-58,-55,-51,-9,-48,-28,-54,-2,-34,-11,LONG
-33,35,36,71,15,24,20,35,-1,-10,-66,-33,18,2,-45,-34,14,5,-46,-15,4,-3,-39,-19,SHORT
-28,1,32,33,71,15,24,20,-33,-32,6,-28,-34,-42,-60,-61,-15,-30,-39,-62,-19,-27,-40,-43,SHORT
-47,8,53,61,75,89,55,179,11,-28,-14,-47,17,-36,-8,-36,-6,-1,-7,-30,46,-100,18,-53,SHORT
118,123,27,150,65,51,89,173,-20,100,15,118,-10,116,17,98,-55,87,26,108,-222,-79,-56,63,LONG
-61,24,79,103,65,164,70,155,-50,-32,-70,-61,-4,-98,-37,-111,-9,-7,-40,-65,80,-6,46,-70,SHORT
26,57,11,68,85,106,67,76,-55,-33,-16,26,-92,-73,-35,-29,-72,-79,-80,-66,-59,-78,-70,-46,SHORT
-25,6,33,39,55,40,40,26,16,-11,5,-25,-10,-2,-1,-9,10,-2,-1,-35,20,6,-7,-15,SHORT
-18,30,18,48,39,55,40,40,-25,-33,-42,-18,-9,-44,-37,-43,-35,-35,-43,-27,-15,-35,-43,-53,SHORT
-76,4,99,103,80,137,182,81,-20,-47,-70,-76,64,-25,9,-96,110,58,137,-12,125,91,69,34,SHORT
49,52,3,55,34,120,84,53,10,40,19,49,-83,-45,20,59,-144,-114,-85,-34,-112,-92,-94,-95,LONG
-50,1,54,55,51,100,73,155,-6,-38,-42,-50,20,-44,1,-56,64,9,27,-30,-3,-12,88,14,SHORT
-119,9,123,132,46,56,70,76,-21,-33,-119,-119,25,-20,-96,-140,11,-20,-82,-94,20,-10,-66,-108,SHORT
-43,8,45,53,25,55,85,17,-15,-21,-49,-43,8,-43,-41,-58,55,-28,4,-35,62,52,16,12,SHORT
-65,11,65,76,55,64,46,65,14,-6,-27,-65,49,-15,-27,-51,58,35,5,-16,98,52,41,-7,SHORT
-34,12,35,47,45,26,39,61,18,-9,-11,-34,33,8,-13,-16,16,7,-1,-1,50,-2,12,-18,SHORT
-88,3,88,91,78,36,38,78,71,-4,-17,-88,100,69,14,-17,76,64,11,12,111,33,20,-12,SHORT
-55,12,62,74,91,78,36,38,-88,-81,-64,-55,-17,-85,-81,-143,12,-12,-50,-72,-12,-17,-53,-43,SHORT
162,164,137,301,161,51,65,74,110,284,144,162,77,373,123,272,34,313,77,239,76,305,78,196,LONG
-49,5,75,80,142,97,53,103,-26,-104,-42,-49,28,-23,-6,-75,20,18,-9,-21,87,41,64,-29,SHORT
60,61,24,85,68,56,35,77,12,53,36,60,16,61,32,72,16,88,38,76,-18,61,53,76,LONG
40,61,10,71,69,74,88,72,-2,45,43,40,9,-11,-8,38,-13,-3,14,49,-43,-24,-23,27,LONG
9,11,9,20,25,32,46,31,21,16,21,9,-1,15,27,30,-39,-26,0,8,-50,-41,-30,-30,LONG
-27,8,37,45,28,65,50,10,-15,-7,-24,-27,23,-25,-5,-42,16,1,6,-4,16,20,-15,-11,SHORT
-15,11,17,28,65,50,10,19,38,-18,19,-15,31,8,30,23,31,27,9,16,25,27,18,16,SHORT
-29,9,29,38,29,23,19,41,-17,-25,-34,-29,-9,-26,-41,-46,-1,-10,-29,-38,-11,-33,-30,-30,SHORT
-18,8,18,26,18,35,27,32,5,-12,-20,-18,33,-2,7,-13,9,7,8,15,-6,-12,-6,-9,SHORT
-45,5,46,51,24,26,18,35,0,-5,-32,-45,-18,-17,-42,-45,-13,-29,-62,-63,15,-19,-35,-58,SHORT
-9,55,20,75,156,71,57,44,80,-43,38,-9,25,36,32,71,36,24,6,16,52,39,8,27,SHORT
-20,23,43,66,75,156,71,57,-9,3,12,-20,71,-40,50,-29,16,39,44,51,27,27,18,-4,SHORT
-63,9,66,75,48,41,54,49,3,-9,-36,-63,10,1,-33,-60,29,-8,-29,-53,28,-8,-34,-34,SHORT
61,63,0,63,62,83,56,92,-23,23,22,61,-58,-16,4,38,-81,-48,-55,3,-140,-79,-50,-20,LONG
-47,8,48,56,11,23,19,23,2,-4,-49,-47,19,-1,-34,-45,21,11,-26,-28,4,4,-29,-26,SHORT
27,44,6,50,46,15,11,14,30,17,13,27,24,53,18,57,20,48,9,51,9,42,6,47,LONG
-4,16,11,27,34,21,37,101,-11,-12,-5,-4,-5,-16,-22,-15,-23,-17,-7,-9,69,-17,57,-27,SHORT
70,70,1,71,52,132,96,52,20,50,31,70,-87,-17,44,90,-148,-87,-62,-17,-150,-113,-132,-78,LONG
-2,16,36,52,69,78,43,63,-43,-20,-3,-2,9,-9,17,-45,-8,17,8,7,28,10,21,-10,SHORT
-232,14,241,255,79,68,65,64,19,-17,-193,-232,-1,-39,-226,-213,19,-15,-205,-233,10,-28,-219,-213,SHORT
-64,0,71,71,55,28,61,85,-23,-33,-49,-64,-20,-30,-73,-87,12,-26,-36,-84,94,17,31,-52,SHORT
-38,15,103,118,172,105,62,75,55,-51,3,-38,45,67,54,17,51,91,35,7,84,109,66,13,SHORT
-73,46,77,123,118,172,105,62,-38,-99,-104,-73,17,-150,-101,-111,7,-32,-50,-56,13,-8,-69,-66,SHORT
-43,11,52,63,49,47,26,30,-27,-32,-46,-43,-1,-32,-48,-70,9,-2,-39,-44,29,18,-15,-34,SHORT
24,35,3,38,26,52,23,42,9,12,0,24,-21,3,17,33,-33,-8,-23,3,-59,-32,-28,-9,LONG
-42,16,49,65,57,63,79,32,-13,-46,-54,-42,0,-7,-9,-55,76,4,18,-42,67,53,20,34,SHORT
37,50,29,79,52,68,53,49,-21,37,10,37,-56,-6,-17,16,-65,-23,-49,-19,-84,-36,-66,-28,LONG
-149,61,151,212,167,193,509,93,-21,-74,-119,-149,47,-68,-87,-170,527,21,318,-102,491,482,363,378,SHORT
20,47,8,55,43,89,32,45,23,20,8,20,-54,-28,6,43,-50,-34,-57,-34,-62,-38,-48,-30,LONG
-107,22,107,129,77,51,125,73,-37,-71,-123,-107,-11,-43,-121,-144,60,-55,-59,-118,15,3,-53,-47,SHORT
-32,2,33,35,24,26,19,20,-13,-19,-30,-32,0,-20,-29,-45,-10,-11,-27,-32,-16,-15,-30,-42,SHORT
11,27,6,33,48,47,29,35,-5,2,17,11,-45,-33,-19,6,-64,-51,-55,-34,-96,-80,-78,-53,LONG
33,39,23,62,70,43,71,41,27,49,57,33,0,45,26,60,-19,30,39,33,-11,31,10,14,LONG
73,104,25,129,72,95,134,83,-7,81,24,73,-36,36,2,66,-156,-69,-64,37,-160,-108,-154,-83,LONG
-10,0,40,40,43,53,59,51,0,-2,1,-10,-26,1,14,-10,4,-16,3,-36,-43,-14,-3,-6,SHORT
-45,4,46,50,40,43,53,59,-10,-39,-49,-45,-10,-41,-48,-55,-36,-38,-35,-55,-6,-55,-46,-81,SHORT
-119,22,124,146,101,100,46,61,9,-49,-94,-119,-17,-17,-63,-110,-17,-53,-153,-136,0,-37,-122,-136,SHORT
-41,5,41,46,22,7,23,10,-5,-17,-41,-41,-6,-11,-50,-46,-23,-27,-50,-47,-29,-31,-67,-64,SHORT
-34,6,41,47,39,31,40,45,-2,-15,-23,-34,5,1,-15,-36,4,-14,-21,-29,28,-8,-10,-30,SHORT
34,54,21,75,62,100,59,81,-22,15,2,34,-85,-38,-13,12,-119,-82,-98,-51,-182,-134,-128,-85,LONG
-116,13,122,135,93,67,65,88,40,4,-38,-116,59,-2,-70,-76,19,18,-52,-57,65,18,-29,-97,SHORT
-46,8,52,60,34,46,69,52,25,-3,-29,-46,44,9,-5,-21,73,26,35,-2,68,61,53,27,SHORT
-20,6,63,69,60,34,46,69,-46,-9,-18,-20,-21,-12,-47,-66,-2,0,-23,-41,27,17,17,-22,SHORT
31,34,2,36,74,95,178,46,16,27,65,31,-65,-41,18,47,-207,-209,-67,-34,-203,-197,-187,-176,LONG
20,41,1,42,23,36,31,35,11,14,-5,20,-14,4,-2,31,-43,-22,-33,6,-58,-46,-53,-23,LONG
-116,0,136,136,50,103,49,39,2,-4,-90,-116,56,-24,-57,-114,102,73,-14,-60,96,92,-5,-14,SHORT
-35,12,36,48,52,57,86,87,-1,0,4,-35,19,-6,3,-36,74,15,53,-16,105,70,109,39,SHORT
133,133,3,136,204,444,81,77,38,24,92,133,-364,-237,71,171,-368,-290,-345,-231,-333,-253,-312,-235,LONG
-10,35,10,45,65,67,51,57,-50,-50,-30,-10,-35,-52,-30,-60,-16,-40,-34,-45,-24,-47,-35,-26,SHORT
-66,12,121,133,99,78,155,116,-37,-29,-63,-66,-9,0,-55,-103,-120,-90,-68,-75,-32,-79,-96,-186,SHORT
-10,13,24,37,24,49,27,29,-8,0,-13,-10,17,-15,-3,-18,12,17,7,7,-7,0,-8,2,SHORT
11,12,33,45,35,39,60,38,-3,35,25,11,-33,5,-1,8,-54,-28,-13,-22,-65,-21,-28,-43,LONG
43,43,7,50,45,35,39,60,11,17,12,43,8,52,37,54,-22,22,11,51,-43,-11,-1,21,LONG
-69,11,77,88,55,39,70,65,13,-23,-56,-69,29,4,-45,-56,38,19,1,-40,-12,-9,-32,-31,SHORT
-82,18,92,110,88,55,39,70,-69,-67,-89,-82,-56,-90,-145,-151,-40,-63,-134,-138,-31,-48,-88,-122,SHORT
61,64,45,109,136,429,169,277,-50,-25,2,61,-330,-224,96,11,-304,-318,-258,-269,-99,-241,-73,-243,LONG
90,143,23,166,109,136,429,169,61,68,11,90,11,43,13,151,-269,-156,107,101,-243,-250,-247,-179,LONG
-113,49,151,200,530,285,238,500,335,-91,239,-113,137,168,253,222,68,104,142,24,-345,-371,-71,-45,SHORT
-413,23,477,500,128,96,75,70,28,8,-364,-413,95,72,-332,-385,105,119,-306,-318,92,144,-286,-308,SHORT
34,61,5,66,90,109,67,146,32,23,47,34,-28,0,43,66,14,4,5,6,-117,-83,-3,48,LONG
-140,17,141,158,92,107,44,47,-19,-28,-94,-140,46,-23,-74,-159,42,25,-89,-94,51,9,-102,-98,SHORT
83,98,22,120,62,74,47,24,24,93,35,83,-9,60,14,107,-31,67,-6,74,-34,62,-34,52,LONG
15,21,12,33,24,12,15,24,5,20,11,15,4,30,9,20,2,19,1,19,34,52,43,63,LONG
10,17,0,17,15,33,24,12,13,8,6,10,28,11,27,23,33,31,38,38,32,41,36,43,LONG
13,13,2,15,33,24,12,15,15,3,21,13,20,23,32,28,19,33,30,33,17,22,22,32,LONG
29,43,1,44,31,35,100,29,-4,9,-4,29,-15,15,6,25,74,6,62,14,61,90,75,103,LONG
-29,15,34,49,40,86,88,44,-18,-32,-41,-29,38,-29,8,-47,118,42,81,9,147,122,117,89,SHORT
19,25,31,56,102,43,22,28,6,-16,30,19,-17,18,5,25,-14,20,-14,2,-35,15,-13,5,LONG
-160,33,172,205,105,99,118,101,49,-18,-118,-160,26,-38,-144,-111,101,11,-76,-134,139,80,-24,-59,SHORT
-17,40,40,80,94,86,170,84,-64,-68,-54,-17,-34,-49,-43,-81,100,-15,75,-51,147,87,91,83,SHORT
-16,11,33,44,80,94,86,170,-17,-23,13,-16,-81,-91,-41,-33,-51,-72,-30,-97,83,-38,88,-67,SHORT
56,66,7,73,73,61,53,74,25,55,55,56,-11,35,23,81,4,44,24,45,-45,18,19,60,LONG
19,35,1,36,73,73,61,53,56,13,50,19,81,68,105,75,45,48,73,100,60,57,74,64,LONG
-50,1,52,53,36,37,51,30,18,2,-15,-50,-6,-7,-23,-32,41,-4,-6,-56,20,22,-1,-9,SHORT
28,33,7,40,26,33,38,39,8,33,19,28,-8,23,16,36,-23,8,6,20,-29,-19,-20,5,LONG
-41,28,53,81,20,26,57,57,6,5,-56,-41,-2,0,-55,-35,49,4,-20,-41,8,15,-9,8,SHORT
-21,9,43,52,81,20,26,57,-41,-31,-2,-21,-35,-26,-58,-62,-43,-31,-57,-56,8,-27,-22,-62,SHORT
-21,39,40,79,92,152,139,244,59,-14,-1,-21,79,-6,67,38,48,-4,56,58,157,21,186,27,SHORT
-46,5,57,62,79,92,152,139,-21,-29,-12,-46,38,-43,-13,-67,58,-35,55,-8,27,-33,44,12,SHORT
53,67,18,85,164,128,333,144,-98,-78,1,53,-176,-113,-70,-45,113,-131,117,-123,244,179,238,166,LONG
81,184,33,217,85,164,128,333,53,96,-36,81,-45,18,-35,134,-123,-17,-106,36,166,-35,81,-42,LONG
131,139,5,144,332,80,109,117,-53,-107,81,131,-78,52,-12,78,-25,6,-29,53,-99,9,-18,106,LONG
-3,15,4,19,76,48,34,38,23,-50,7,-3,-7,-11,18,20,8,-8,7,-10,29,6,25,5,SHORT
-17,8,20,28,19,76,48,34,-3,-1,-10,-17,20,-51,-3,-20,-10,-12,8,3,5,-9,-3,-27,SHORT
-65,16,68,84,55,28,19,76,6,-13,-42,-65,-11,-11,-67,-59,-14,-12,-77,-76,9,-62,-70,-79,SHORT
142,180,27,207,162,120,249,207,-42,27,-18,142,-96,32,-55,100,-172,-120,-78,46,-139,-87,-87,-30,LONG
-39,2,41,43,73,42,42,51,-3,-36,-6,-39,33,-5,-6,-42,53,34,33,-6,90,48,56,14,SHORT
-11,36,32,68,94,63,98,102,31,-33,-7,-11,58,45,40,20,42,48,78,47,22,-26,8,31,SHORT
-2,50,18,68,68,94,63,98,-11,-16,-16,-2,20,-49,-23,-13,47,29,24,18,31,32,62,45,SHORT
-53,1,83,84,68,68,94,63,-2,12,-4,-53,-13,-4,-20,-55,18,-37,-27,-66,45,41,20,-35,SHORT
20,26,15,41,71,41,52,61,-52,-20,10,20,-27,-18,-18,-32,-61,-30,-19,-7,-49,-30,-10,-41,LONG
28,39,39,78,41,71,41,52,20,52,15,28,-32,32,25,48,-7,34,-3,-4,-41,22,-4,21,LONG
-123,8,131,139,142,128,449,63,46,-74,-71,-123,-25,-48,-59,-77,333,-97,213,-148,313,314,238,210,SHORT
130,146,2,148,117,152,132,159,-90,19,-12,130,-188,-81,-77,40,-93,-70,-86,-58,54,28,39,37,LONG
54,98,2,100,96,95,68,103,19,-21,-25,54,-18,22,17,73,-43,-13,-45,36,-50,-58,-55,11,LONG
40,41,10,51,26,20,32,35,1,47,22,40,-8,36,5,41,-27,23,4,32,-3,21,5,13,LONG
27,30,6,36,51,26,20,32,40,23,38,27,41,70,60,67,32,59,43,68,13,46,42,59,LONG
-31,21,36,57,128,130,83,73,103,5,76,-31,34,-5,68,72,26,-21,5,3,35,20,36,-5,SHORT
-47,32,57,89,89,60,92,47,-44,-63,-63,-47,-14,-51,-80,-91,51,-24,-21,-61,72,48,6,4,SHORT
-38,21,60,81,72,63,134,55,15,-6,-15,-38,39,23,5,-23,143,46,99,1,121,117,91,105,SHORT
-78,5,78,83,70,34,86,77,56,-3,-16,-78,75,56,7,-22,41,-4,-1,-3,91,15,9,-37,SHORT
-20,5,29,34,83,70,34,86,-78,-69,-20,-20,-22,-72,-36,-98,-3,-13,-13,-42,-37,-73,-21,-23,SHORT
37,37,5,42,53,33,28,12,5,15,26,37,12,28,19,42,17,33,19,34,11,51,21,54,LONG
28,34,15,49,50,113,69,86,19,18,19,28,-36,-51,13,47,-63,-31,-11,-8,-107,-79,-42,-35,LONG
46,56,4,60,49,50,113,69,28,35,24,46,47,53,43,74,-8,-16,37,93,-35,4,13,38,LONG
55,56,17,73,105,62,104,66,-18,38,70,55,-50,10,-1,37,-129,-58,-27,5,-90,-63,-70,-74,LONG
13,29,40,69,73,105,62,104,55,36,40,13,37,74,110,68,5,46,39,50,-74,-22,13,18,LONG
-11,28,16,44,46,35,65,23,-23,-31,-29,-11,-11,-33,-42,-34,48,-7,14,-22,48,38,17,37,SHORT
61,70,0,70,41,65,29,60,17,55,26,61,-29,30,25,78,-38,11,-30,32,-89,-36,-46,23,LONG
-9,8,21,29,60,72,70,36,-51,-47,-16,-9,14,-45,-2,-60,78,23,64,5,85,67,74,69,SHORT
-43,14,80,94,88,107,100,87,-5,-27,-33,-43,40,23,36,-48,65,9,15,-3,78,91,84,22,SHORT
-80,20,97,117,58,54,35,27,14,7,-52,-80,58,26,-37,-66,34,49,-33,-22,38,31,-59,-46,SHORT
30,31,35,66,50,130,85,117,15,35,19,30,-66,-11,53,45,-109,-46,-27,-36,-189,-141,-90,-79,LONG
-33,12,35,47,31,34,59,60,-23,-29,-45,-33,0,-25,-38,-56,25,-21,-9,-33,71,18,31,-8,SHORT
54,54,1,55,36,27,82,65,15,37,18,54,0,45,17,69,-70,-21,6,54,-18,-19,-9,-16,LONG
-48,20,57,77,185,96,143,96,142,-23,85,-48,104,57,76,94,209,75,141,56,124,133,152,161,SHORT
-46,24,117,141,77,185,96,143,-48,14,-50,-46,94,-9,35,-94,56,71,26,48,161,89,91,10,SHORT
281,282,15,297,88,167,158,76,-18,278,69,281,-143,152,22,263,-285,6,-133,138,-305,-49,-270,-4,LONG
-20,16,60,76,30,40,79,96,-16,19,-27,-20,0,5,-31,-36,6,-33,-30,-20,97,41,61,-14,SHORT
-16,9,21,30,40,79,96,77,16,-14,-4,-16,22,-52,-3,0,113,22,88,6,78,78,125,97,SHORT
32,39,19,58,53,81,45,145,-25,-1,-6,32,29,10,33,7,28,59,46,61,-98,-66,21,60,LONG
54,65,16,81,45,145,98,90,-1,49,13,54,-127,-76,-12,53,-117,-127,-110,-73,-150,-97,-88,-63,LONG
65,71,10,81,85,87,132,59,-12,28,32,65,-11,37,43,53,-121,-67,-16,54,-173,-103,-125,-56,LONG
-52,2,57,59,62,68,101,46,27,3,6,-52,21,-4,5,-25,102,25,67,-31,123,85,72,50,SHORT
-46,19,47,66,55,39,89,35,-45,-54,-65,-46,-27,-53,-80,-91,60,-28,-5,-73,76,42,11,14,SHORT
-151,2,153,155,92,98,193,87,54,-34,-97,-151,-18,-30,-87,-97,121,-69,-31,-169,169,85,17,-30,SHORT
16,16,19,35,59,40,84,72,6,-5,19,16,4,21,26,22,-72,-43,6,20,-11,-45,-8,-56,LONG
100,118,13,131,45,142,64,83,15,107,21,100,-88,-9,2,115,-125,-15,-82,12,-170,-91,-139,-25,LONG
-37,24,40,64,83,57,57,81,-45,-76,-57,-37,-5,-47,-54,-82,-4,-14,-21,-42,36,-12,5,-41,SHORT
40,70,11,81,59,189,185,110,-1,35,13,40,-140,-99,9,39,-303,-255,-151,-100,-256,-280,-251,-263,LONG
-163,19,166,185,110,58,117,100,47,-25,-100,-163,52,30,-97,-116,14,-15,-83,-111,82,0,-85,-149,SHORT
-103,38,109,147,81,149,64,109,45,-11,-77,-103,-87,-92,-90,-58,-33,-87,-170,-190,64,-39,-77,-136,SHORT
60,61,65,126,58,125,151,35,-19,74,6,60,-71,37,36,41,-109,-79,-54,-11,-134,-9,-100,-49,LONG
-26,20,27,47,32,56,27,32,5,-8,-23,-26,58,3,12,-21,84,58,38,32,69,61,46,58,SHORT
-49,26,49,75,47,32,56,27,-26,-27,-55,-49,-21,-35,-78,-75,32,-24,-43,-70,58,31,-17,-17,SHORT
42,51,69,120,128,84,86,132,38,91,99,42,-10,100,64,80,-22,36,2,32,-139,-29,-17,20,LONG
-14,17,41,58,98,83,93,71,-30,-60,-20,-14,-67,-40,-15,-44,8,-58,-23,-81,52,8,21,-6,SHORT
29,35,36,71,52,87,44,40,14,64,45,29,-19,19,35,43,4,30,3,10,18,51,20,33,LONG
5,11,11,22,99,41,46,32,94,12,89,5,70,69,88,99,72,47,71,75,93,82,92,77,LONG
8,12,31,43,22,99,41,46,5,28,7,8,99,40,96,13,75,97,95,107,77,75,78,83,LONG
14,26,2,28,43,22,99,41,8,-15,0,14,13,13,7,22,107,25,96,27,83,82,95,121,LONG
-152,4,152,156,77,58,58,42,15,-29,-108,-152,46,2,-96,-137,65,18,-80,-106,67,49,-65,-87,SHORT
-69,29,82,111,48,97,73,124,-1,-27,-90,-69,-22,-65,-79,-70,-48,-51,-89,-91,52,-55,-42,-117,SHORT
-21,20,77,97,73,124,66,35,-26,14,-10,-21,74,10,37,-47,59,90,59,53,54,100,38,38,SHORT
18,34,7,41,103,143,115,51,68,-1,61,18,-35,-41,61,86,-147,-125,-51,-17,-168,-172,-162,-129,LONG
32,34,12,46,51,41,103,143,1,4,9,32,19,38,33,33,87,37,94,51,-16,-3,94,119,LONG
-21,18,33,51,14,23,29,22,-11,0,-37,-21,-8,-12,-40,-32,-11,-8,-30,-29,-21,-18,-47,-32,SHORT
-25,0,25,25,51,14,23,29,-3,-15,11,-7,-14,-15,-26,-28,-11,-27,-29,-39,-14,-23,-19,-36,SHORT
55,79,20,99,65,72,44,76,41,65,31,55,-24,46,19,96,-53,7,-48,31,-12,-1,-24,2,LONG
-28,38,34,72,41,50,88,115,28,-2,-33,-28,13,2,-20,0,-47,-54,-38,-15,63,-44,-1,-75,SHORT
-62,13,76,89,72,41,50,88,-28,-20,-37,-62,0,-22,-70,-90,-15,-18,-57,-62,-75,-74,-75,-77,SHORT
-101,47,116,163,97,134,111,129,-7,-18,-84,-101,103,-5,-34,-108,168,116,64,2,155,95,61,67,SHORT
39,39,32,71,94,91,40,64,57,51,74,39,6,55,75,96,-3,43,12,45,30,48,41,36,LONG
166,166,0,166,150,41,44,35,-53,60,44,166,-61,82,-43,113,-38,85,-37,105,-30,114,-17,128,LONG
-47,4,47,51,41,59,60,112,-10,-28,-38,-47,-14,-26,-18,-57,30,-22,-13,-61,-53,-66,-5,-17,SHORT
17,20,31,51,44,62,58,46,-2,30,23,17,-44,0,11,15,-43,-37,-30,-27,-5,4,-1,-26,LONG
-41,1,63,64,65,95,63,90,29,-14,-13,-41,83,23,54,-12,41,46,45,42,115,52,78,0,SHORT
-55,4,83,87,64,65,95,63,-41,-35,-58,-55,-12,-49,-71,-96,42,-12,-4,-67,0,11,-13,-13,SHORT
56,57,13,70,39,40,49,47,34,67,36,56,9,66,36,90,-12,43,22,65,-11,39,16,44,LONG
-62,9,73,82,78,106,90,75,-41,-46,-50,-62,13,-70,-46,-103,82,24,32,-49,35,30,23,20,SHORT
-41,21,57,78,106,90,75,66,54,-24,4,-41,123,70,82,13,76,76,73,82,97,86,74,35,SHORT
107,115,47,162,44,67,60,62,-10,144,26,107,-54,88,-7,97,-106,44,-58,53,-100,21,-79,1,LONG
-52,4,56,60,62,71,39,42,6,-23,-21,-52,64,8,19,-46,72,53,32,12,108,72,54,20,SHORT
38,44,7,51,100,44,85,40,26,20,69,38,43,44,37,64,-30,3,37,81,-10,0,-11,8,LONG
57,59,11,70,34,45,39,65,15,61,25,57,-12,56,31,72,-17,37,6,45,-31,-4,-9,40,LONG
-27,1,32,33,42,40,53,88,-6,-15,-6,-27,-5,-11,-4,-33,29,-6,14,-32,-43,-38,17,2,SHORT
-72,16,72,88,38,59,36,38,-26,-32,-82,-72,22,-26,-55,-98,13,12,-40,-50,7,7,-43,-59,SHORT
14,18,23,41,24,55,38,50,1,35,18,14,-24,13,27,15,-53,-22,-25,-10,-21,-32,-23,-39,LONG
-36,27,36,63,35,83,67,76,-6,-21,-49,-36,87,47,67,22,69,33,37,51,88,37,50,33,SHORT
-27,16,32,48,63,35,83,67,-36,-31,-16,-27,-42,-52,-65,-63,51,16,51,-5,33,2,21,24,SHORT
85,85,0,85,59,99,65,69,31,79,53,85,-38,26,40,116,-25,41,21,47,-50,-9,-25,60,LONG
-12,11,12,23,39,47,41,27,-17,-18,-2,-12,23,-18,6,-29,43,8,26,11,59,38,42,31,SHORT
-40,3,40,43,23,39,47,41,-12,-12,-32,-40,-29,-30,-34,-52,11,-30,-26,-69,31,-4,-6,-29,SHORT
-18,10,35,45,34,42,50,103,-2,-8,-19,-18,3,-16,-19,-20,-19,-7,-2,-15,83,-2,56,-37,SHORT
16,16,71,87,94,78,172,221,35,44,51,16,-11,62,53,51,-128,-66,19,5,-184,-198,-64,-112,LONG
-60,16,62,78,41,60,63,25,3,-16,-53,-60,47,-11,-29,-57,50,7,-8,-13,43,44,-9,-10,SHORT
-31,47,55,102,76,156,62,64,-25,-15,-41,-31,113,-8,46,-56,109,105,65,82,126,93,55,78,SHORT
26,33,14,47,30,33,37,35,-5,29,12,26,-4,26,12,21,-7,27,17,22,-13,1,-11,19,LONG
38,51,14,65,47,30,33,37,26,38,20,38,21,67,32,64,22,64,32,59,19,65,37,60,LONG
26,33,9,42,36,26,35,41,12,17,11,26,9,35,19,38,-15,11,4,35,-49,-18,-19,11,LONG
12,18,18,36,26,35,41,25,-3,18,8,12,-27,-6,-7,9,-61,-35,-30,-15,-56,-36,-47,-49,LONG
-24,0,25,25,15,20,11,23,4,-2,-12,-24,-6,-6,-11,-20,-3,-11,-25,-30,16,-6,-8,-27,SHORT
-40,0,41,41,25,15,20,11,-24,-24,-40,-40,-20,-26,-52,-64,-30,-30,-51,-60,-27,-35,-65,-70,SHORT
-24,5,45,50,41,60,53,29,-32,-19,-28,-24,18,-17,-7,-56,35,33,36,-6,51,45,24,11,SHORT
-32,11,56,67,100,63,61,129,-19,-38,-5,-32,-24,-34,-38,-51,23,-10,-16,-56,73,14,76,-9,SHORT
-125,21,125,146,80,69,118,170,-35,-58,-124,-125,-6,-56,-133,-160,24,-87,-115,-131,127,-32,-8,-101,SHORT
-87,11,113,124,93,62,146,67,-24,-59,-90,-87,-26,-39,-101,-111,106,-6,16,-113,111,82,25,19,SHORT
-21,18,27,45,56,55,123,51,-35,-37,-26,-21,-15,-61,-51,-56,53,-58,20,-36,24,19,25,32,SHORT
-25,70,35,105,175,110,170,385,125,-30,40,-25,135,65,70,100,270,130,195,110,655,280,560,245,SHORT
-110,5,130,135,105,175,110,170,-25,-15,-45,-110,100,-45,-5,-135,110,50,25,-10,245,115,150,0,SHORT
70,70,15,85,90,155,85,100,20,40,45,70,-90,-10,60,90,-95,-25,-25,-20,-110,-80,-65,-25,LONG
20,45,45,90,155,85,100,90,-110,-50,15,20,-115,-65,-70,-90,-130,-120,-110,-95,-65,-65,-65,-110,LONG
45,45,25,70,60,95,30,50,20,35,25,45,-70,-5,20,65,-60,-10,-50,-25,-90,-30,-50,-15,LONG
-25,25,45,70,45,55,50,25,-45,-25,-50,-25,-15,-45,-60,-70,-35,-20,-40,-40,-55,-40,-85,-60,SHORT
40,45,15,60,45,90,35,50,20,30,15,40,-60,-10,20,60,-40,-15,-40,-20,-60,-10,-20,0,LONG
5,40,0,40,60,45,90,35,40,-10,10,5,60,20,25,45,-20,-20,30,65,0,-25,-30,-15,LONG
-225,5,230,235,240,195,170,170,160,-75,-70,-225,235,45,5,-65,245,125,60,10,325,235,170,20,SHORT
60,65,5,70,85,75,75,110,-10,15,30,60,-10,20,25,50,-10,-10,-5,50,-115,-50,-10,50,LONG
-105,5,105,110,120,85,55,120,90,-15,-5,-105,140,60,35,-15,110,95,40,35,60,40,50,5,SHORT
60,100,0,100,65,40,35,35,10,60,25,60,20,55,-5,70,35,60,-5,80,25,70,5,95,LONG
-65,5,95,100,65,50,65,65,15,-5,-40,-65,-5,15,-35,-50,25,15,-20,-70,60,35,0,-40,SHORT
10,40,40,80,90,85,65,85,40,35,45,10,-25,20,25,50,-35,-20,-35,-15,-90,-70,-65,-25,LONG
-75,15,105,120,20,25,70,55,0,15,-85,-75,-10,10,-85,-75,-5,-5,-55,-75,25,15,-50,-80,SHORT
-60,0,70,70,70,40,40,40,-25,-55,-55,-60,-5,-25,-55,-85,5,-15,-45,-65,20,5,-25,-55,SHORT
-150,25,150,175,155,110,105,80,60,-45,-65,-150,135,35,-30,-90,180,95,25,-15,160,115,20,30,SHORT
15,25,25,50,110,130,65,75,75,10,70,15,-35,5,85,90,-40,0,15,-20,5,-5,20,-25,LONG
-100,50,105,155,100,55,90,80,-5,-70,-125,-100,35,-15,-115,-105,115,30,-35,-65,110,50,-25,15,SHORT
80,80,10,90,80,105,65,40,-5,20,10,80,-35,25,40,75,-85,0,-25,45,-55,-5,-55,-5,LONG
-105,5,110,115,85,75,50,95,-20,-70,-100,-105,20,-50,-90,-125,25,10,-55,-85,85,20,0,-80,SHORT
30,40,0,40,50,65,90,30,15,30,40,30,-45,-15,10,45,-80,-55,-5,-15,-65,-50,-60,-50,LONG
-40,50,80,130,50,60,190,125,-5,10,-70,-40,-10,5,-65,-45,85,-55,5,-50,70,10,5,45,SHORT
50,55,5,60,40,50,50,60,-10,30,10,50,-35,20,10,40,-50,-20,-30,15,-85,-50,-50,0,LONG
30,35,30,65,80,65,115,50,-60,-5,10,30,-50,-20,-20,-30,-130,-85,-35,-20,-130,-100,-115,-100,LONG
-80,20,95,115,50,65,170,125,0,-15,-80,-80,-5,-10,-60,-80,105,-45,10,-85,65,75,85,25,SHORT
70,70,45,115,240,130,60,40,-105,0,125,70,-25,-30,-15,-35,-25,65,10,45,-5,85,10,45,LONG
-20,25,25,50,90,35,50,30,-40,-35,5,-20,-30,-35,-50,-60,10,-35,-35,-50,30,5,-15,-10,SHORT
25,30,10,40,55,50,35,40,15,35,50,25,-5,30,40,40,-10,10,5,20,30,25,25,15,LONG
50,65,5,70,90,60,85,105,5,5,25,50,10,30,20,55,-65,-10,5,60,25,-25,10,-15,LONG
-140,5,140,145,110,70,75,70,80,-30,-65,-140,130,70,-5,-60,115,90,20,-10,140,105,30,-25,SHORT
90,90,15,105,80,85,65,65,10,85,60,90,-45,30,10,100,-30,45,5,45,-80,15,-25,60,LONG
-55,0,65,65,45,55,30,45,5,-20,-40,-55,-15,-30,-40,-50,-5,-10,-45,-70,0,-5,-25,-60,SHORT
-35,5,35,40,25,40,25,40,5,-5,-20,-35,25,0,0,-30,30,15,0,-10,45,25,25,-5,SHORT
50,85,35,120,100,80,85,85,-25,35,15,50,-65,-5,-45,25,-65,-15,-50,-15,-125,-60,-95,-15,LONG
-10,90,20,110,65,75,130,85,-10,-55,-100,-10,0,-40,-75,-20,90,-15,5,-10,135,70,45,80,SHORT
30,45,40,85,100,75,75,50,0,-10,5,30,-35,5,-5,30,-65,-10,-20,-5,-95,-40,-75,-35,LONG
10,20,25,45,20,20,20,20,15,35,10,10,5,35,10,25,-5,20,-5,15,-15,15,-10,5,LONG
120,135,45,180,170,80,70,195,-100,65,55,120,-100,35,-65,20,-165,0,-110,20,-115,-135,-120,-45,LONG
-65,5,65,70,195,115,65,110,50,-135,-10,-65,130,20,65,-15,110,110,105,65,70,60,100,45,SHORT
-15,5,20,25,25,50,60,20,5,5,5,-15,-5,-25,0,-10,30,-20,15,-20,25,15,10,15,SHORT
30,30,25,55,40,95,45,40,-15,25,10,30,-55,0,40,15,-30,0,-10,-25,5,20,5,0,LONG
-15,15,20,35,20,35,45,55,-10,-15,-30,-15,0,-10,-10,-25,5,0,10,-15,55,10,30,-10,SHORT
-50,35,55,90,45,35,20,35,10,-5,-50,-50,-5,-5,-60,-40,-15,-20,-90,-55,-5,-15,-70,-65,SHORT
-175,0,175,175,60,70,120,110,-25,-35,-150,-175,35,-30,-135,-200,25,-25,-80,-140,55,10,-55,-150,SHORT
45,45,55,100,105,115,70,85,-60,15,20,45,-170,-70,-55,-15,-175,-95,-125,-125,-170,-100,-115,-130,LONG
-165,5,170,175,115,105,130,70,40,-25,-85,-165,85,40,-30,-125,-10,-25,-70,-80,0,-5,-110,-175,SHORT
65,65,0,65,30,55,30,40,-20,45,10,65,-50,0,-10,45,-45,0,-35,15,-15,20,-5,20,LONG
-55,230,60,290,355,560,205,650,-70,-310,-245,-55,285,-120,150,-125,435,235,150,230,865,225,585,380,SHORT
20,30,30,60,55,65,50,75,20,20,15,20,-40,5,10,40,-65,-25,-35,-20,-5,-30,-15,-45,LONG
45,65,20,85,75,60,115,60,-15,35,25,45,0,45,20,30,-60,-30,0,45,-50,-15,-40,-15,LONG
-45,10,50,60,50,65,45,40,10,-20,-30,-45,45,5,10,-35,30,35,20,0,35,35,15,-15,SHORT
40,40,25,65,55,60,125,40,-25,35,25,40,-15,5,0,15,-55,-40,20,25,-50,0,-25,-15,LONG
-50,70,80,150,50,130,80,95,5,-5,-105,-50,-65,-85,-105,-45,15,-35,-105,-115,-45,-20,-75,-35,SHORT
10,35,20,55,95,90,80,105,35,25,65,10,0,25,60,45,5,-20,5,10,25,-10,40,15,LONG
15,20,30,50,35,70,60,40,-15,30,15,15,-80,-35,-15,0,-95,-75,-65,-65,-75,-55,-65,-80,LONG
-50,20,70,90,65,50,50,70,-25,-20,-45,-50,-10,-10,-50,-75,25,10,-30,-60,75,30,10,-25,SHORT
115,125,15,140,180,190,205,95,175,130,170,115,10,120,170,290,-60,-65,0,125,-115,-5,-50,55,LONG
-55,20,75,95,110,265,205,65,-65,-80,-65,-55,140,-65,105,-120,0,10,120,85,-10,-35,-65,-55,SHORT
-60,30,70,100,85,85,45,65,-60,-65,-80,-60,10,-65,-80,-120,-15,-10,-65,-50,5,-25,-60,-75,SHORT
-65,25,65,90,60,90,40,85,-25,-50,-80,-65,25,-35,-35,-90,0,-10,-60,-40,45,-40,-45,-65,SHORT
15,65,10,75,105,90,100,145,40,-5,25,15,20,10,25,55,40,35,60,35,-5,5,75,55,LONG
75,95,25,120,85,170,60,115,25,80,45,75,-115,-40,10,100,-110,-50,-110,-40,-25,-35,-40,-35,LONG
-140,5,165,170,60,115,80,235,5,-10,-120,-140,90,5,-50,-135,130,90,0,-50,-65,-80,-15,-10,SHORT
-85,5,115,120,115,85,90,80,-20,-65,-70,-85,-10,-60,-95,-105,-50,-55,-85,-95,-30,-50,-90,-135,SHORT
25,65,15,80,65,45,50,85,35,40,25,25,55,50,15,60,5,45,15,80,50,20,25,30,LONG
-145,0,155,155,115,175,120,155,40,-10,-50,-145,-50,-75,-55,-105,20,-50,-85,-195,95,-5,-5,-125,SHORT
75,110,55,165,280,285,370,285,-225,-105,10,75,-290,-175,-55,-150,-115,-305,-100,-215,15,-45,75,-40,LONG
35,60,30,90,100,65,20,45,-35,15,25,35,-100,-35,-60,0,-80,-35,-105,-65,-75,-45,-90,-45,LONG
30,95,5,100,180,145,195,135,115,35,115,30,0,25,70,145,-90,-120,-25,30,-135,-130,-95,-60,LONG
-135,30,150,180,70,75,100,125,-60,-50,-160,-135,-20,-45,-150,-195,-35,-40,-120,-155,-60,-105,-160,-170,SHORT
-20,15,30,45,55,50,60,215,20,-25,-15,-20,25,-10,-5,0,-15,-5,10,5,185,-15,155,-35,SHORT
-10,10,15,25,45,55,50,60,-20,-25,-5,-10,0,-50,-20,-30,5,-35,-10,-10,-35,-30,5,-5,SHORT
5,10,30,40,50,50,25,35,-5,0,10,5,30,30,40,0,30,55,40,35,-5,30,25,35,LONG
-45,10,65,75,115,55,75,90,5,-65,-25,-45,-30,-15,-35,-40,10,-20,-20,-75,85,25,40,-35,SHORT
20,65,15,80,95,85,110,85,-20,-10,5,20,-80,-45,-40,0,-60,-70,-40,-60,-115,-95,-90,-40,LONG
85,105,5,110,110,105,195,80,65,90,90,85,65,90,85,150,-105,-30,55,150,-75,-25,-55,-20,LONG
-5,45,5,50,40,30,45,40,-20,-20,-30,-5,-30,-40,-60,-25,0,-40,-45,-35,0,-35,-45,-5,FLAT
15,30,5,35,50,40,30,45,-5,15,30,15,-25,-5,0,10,-35,-25,-30,-10,-5,-25,-15,-20,FLAT
-55,0,65,65,35,50,40,30,15,5,-25,-55,10,20,5,-40,-10,0,-25,-45,-20,-20,-55,-65,FLAT
15,30,10,40,65,35,50,40,-55,-40,-15,15,-40,-35,-40,-40,-45,-20,-10,-25,-65,-40,-40,-30,FLAT
75,75,10,85,40,65,35,50,15,75,30,75,-40,35,15,90,-25,40,-10,35,-30,55,20,50,FLAT
50,75,0,75,85,40,65,35,75,40,50,50,90,115,80,125,35,75,65,140,50,80,40,85,FLAT
-115,70,145,215,75,85,40,65,50,30,-110,-115,125,70,-60,-65,140,145,-30,10,85,105,-45,25,FLAT
-35,40,35,75,215,75,85,40,-115,-145,-5,-35,-65,-115,-115,-150,10,-75,-65,-100,25,0,-35,-25,FLAT
0,30,35,65,75,215,75,85,-35,0,10,0,-150,-145,5,-35,-100,-115,-105,-150,-25,-75,-55,-100,FLAT
30,70,10,80,65,75,215,75,0,5,-10,30,-35,5,0,30,-150,-140,-5,-5,-100,-110,-115,-120,FLAT
-170,10,185,195,80,65,75,215,30,5,-110,-170,30,10,-120,-140,-5,10,-110,-140,-120,-135,-115,-175,FLAT
0,40,65,105,195,80,65,75,-170,-120,-30,0,-140,-115,-140,-170,-140,-110,-150,-140,-175,-110,-140,-140,FLAT
65,110,0,110,105,195,80,65,0,0,-5,65,-170,-120,-35,65,-140,-115,-145,-105,-140,-110,-155,-75,FLAT
5,65,25,90,110,110,105,195,85,25,45,5,150,115,135,90,150,115,130,155,-20,-5,100,155,FLAT
-55,105,55,160,90,110,110,105,5,-25,-95,-55,90,0,-50,-50,155,90,40,35,155,90,35,100,FLAT
130,175,10,185,160,90,110,110,-55,85,60,130,-50,60,-35,75,35,85,10,80,100,175,100,165,FLAT
-105,45,110,155,185,160,90,110,130,-5,25,-105,75,80,85,25,80,55,-10,-30,165,80,35,-25,FLAT
40,45,70,115,155,185,160,90,-105,0,40,40,25,-5,65,-65,-30,80,125,65,-25,55,30,10,FLAT
70,85,20,105,115,155,185,160,40,20,30,70,-65,20,70,110,65,15,95,5,10,100,155,135,FLAT
45,90,20,110,105,115,155,185,70,45,40,45,110,65,70,115,5,65,110,155,135,60,135,50,FLAT
-90,20,120,140,110,105,115,155,45,10,-20,-90,115,55,20,-45,155,75,50,25,50,75,90,65,FLAT
110,110,5,115,140,110,105,115,-90,-5,20,110,-45,5,0,20,25,50,40,65,65,70,70,135,FLAT
-5,30,65,95,115,140,110,105,110,55,75,-5,20,50,95,105,65,60,75,15,135,105,115,60,FLAT
75,90,10,100,95,115,140,110,-5,20,15,75,105,75,90,70,15,70,110,180,60,80,90,90,FLAT
-60,20,90,110,100,95,115,140,75,20,10,-60,70,40,25,15,180,95,100,10,90,90,120,120,FLAT
60,65,25,90,110,100,95,115,-60,-5,15,60,15,15,25,0,10,35,40,75,120,90,115,70,FLAT
50,90,10,100,90,110,100,95,60,35,25,50,0,30,40,110,75,50,50,50,70,70,65,125,FLAT
-35,20,60,80,100,90,110,100,50,15,35,-35,110,50,60,15,50,45,75,75,125,65,85,15,FLAT
70,100,10,110,80,100,90,110,-35,20,-10,70,15,35,25,35,75,70,50,85,15,65,65,145,FLAT
-15,55,40,95,110,80,100,90,70,15,30,-15,35,35,20,55,85,50,55,20,145,85,80,70,FLAT
5,280,215,495,95,110,80,100,-15,180,-220,5,55,195,-190,-10,20,215,-200,60,70,230,-165,25,FLAT
75,105,130,235,495,95,110,80,5,-10,250,75,-10,170,30,80,60,185,60,65,25,205,50,135,FLAT
20,145,20,165,235,495,95,110,75,-90,-20,20,80,-100,230,95,65,80,10,100,135,95,40,85,FLAT
-80,35,140,175,165,235,495,95,20,40,30,-80,95,-50,10,-60,100,-60,260,15,85,120,40,20,FLAT
-270,5,290,295,175,165,235,495,-80,-120,-240,-270,-60,-80,-210,-350,15,-170,-230,-330,20,-180,20,-255,FLAT
55,100,10,110,295,175,165,235,-270,-225,-40,55,-350,-345,-280,-215,-330,-305,-250,-295,-255,-395,-270,-275,FLAT
200,225,20,245,110,295,175,165,55,210,75,200,-215,-15,35,255,-295,-135,-205,-15,-275,-95,-175,-95,FLAT
-70,30,80,110,245,110,295,175,200,-10,125,-70,255,200,200,130,-15,-25,160,185,-95,-145,-80,-85,FLAT
45,50,35,85,110,245,110,295,-70,0,25,45,130,-10,150,-25,185,200,225,175,-85,-25,185,230,FLAT
-75,30,115,145,85,110,245,110,45,5,-55,-75,-25,5,-30,-30,175,-5,95,-100,230,205,170,100,FLAT
55,95,10,105,145,85,110,245,-75,-50,-10,55,-30,-45,-65,-20,-100,-45,-40,25,100,-55,85,-45,FLAT
40,55,25,80,105,145,85,110,55,55,80,40,-20,5,70,95,25,10,15,20,-45,10,40,65,FLAT
-5,20,45,65,80,105,145,85,40,15,30,-5,95,70,110,35,20,20,100,90,65,25,45,15,FLAT
-55,15,70,85,65,80,105,145,-5,-30,-50,-55,35,-15,-20,-60,90,40,60,-20,15,-10,50,35,FLAT
20,85,25,110,85,65,80,105,-55,-25,-50,20,-60,-55,-100,-35,-20,-40,-70,-40,35,15,10,0,FLAT
-60,25,60,85,110,85,65,80,20,-25,0,-60,-35,-50,-50,-40,-40,-80,-100,-95,0,-65,-70,-100,FLAT
-20,50,45,95,85,110,85,65,-60,-35,-45,-20,-40,-60,-45,-80,-95,-85,-95,-60,-100,-115,-145,-115,FLAT
85,85,25,110,80,95,85,110,20,95,65,85,0,85,70,105,-60,50,25,85,-40,25,25,25,FLAT
20,25,90,115,110,80,95,85,85,85,80,20,105,180,145,105,85,170,150,125,25,135,105,105,FLAT
90,95,35,130,115,110,80,95,20,35,20,90,105,120,100,110,125,215,165,195,105,205,170,215,FLAT
-40,10,100,110,130,115,110,80,90,25,45,-40,110,60,65,50,195,145,145,70,215,240,210,155,FLAT
75,85,5,90,110,130,115,110,-40,-20,0,75,50,5,45,35,70,40,65,125,155,125,145,145,FLAT
40,65,10,75,90,110,130,115,75,45,60,40,35,25,60,115,125,50,105,75,145,85,125,165,FLAT
-35,15,40,55,75,90,110,130,40,-5,15,-35,115,40,75,5,75,20,75,80,165,45,120,40,FLAT
5,30,85,115,55,75,90,110,-35,50,-10,5,5,45,5,-30,80,90,65,10,40,70,65,85,FLAT
-5,20,10,30,80,35,20,30,-60,-65,-15,-5,-55,-80,-75,-65,-58,-55,-65,-60,-65,-65,-65,-60,FLAT
-10,20,25,45,30,80,35,20,-5,5,-10,-10,-65,-60,-25,-15,-60,-75,-85,-75,-63,-50,-75,-70,FLAT
-50,5,60,65,45,30,80,35,-10,-15,-35,-50,-15,-10,-45,-60,-75,-75,-60,-65,-70,-90,-120,-125,FLAT
-5,25,20,45,65,45,30,80,-50,-45,-25,-5,-60,-60,-60,-55,-65,-55,-70,-65,-125,-120,-85,-70,FLAT
0,25,30,55,45,65,45,30,-5,10,0,0,-55,-35,-25,-5,-65,-50,-60,-55,-70,-45,-70,-65,FLAT
-35,15,65,80,55,45,65,45,0,0,-25,-35,-5,10,-25,-35,-55,-35,-50,-40,-65,-50,-85,-90,FLAT
-20,25,30,55,80,55,45,65,-35,-55,-30,-20,-35,-55,-55,-55,-40,-45,-55,-55,-90,-90,-80,-60,FLAT
40,55,5,60,55,80,55,45,-20,15,10,40,-55,-40,-20,20,-55,-40,-45,-15,-60,-30,-45,-15,FLAT
-25,5,65,70,60,55,80,55,40,35,25,-25,20,50,35,15,-15,-5,5,-5,-15,-5,-20,-40,FLAT
-10,0,50,50,70,60,55,80,-25,-25,-5,-10,15,10,20,-35,-5,25,30,5,-40,-30,0,-15,FLAT
45,75,70,145,50,70,60,55,-10,65,-30,45,-35,40,-35,35,5,75,-10,10,-15,90,0,50,FLAT
-25,80,40,120,145,50,70,60,45,-55,-30,-25,35,10,-60,20,10,-15,-65,10,50,20,-40,-15,FLAT
20,90,15,105,120,145,50,70,-25,-5,10,20,20,-60,-20,-5,10,5,-50,40,-15,-20,-55,30,FLAT
-25,40,85,125,105,120,145,50,20,45,25,-25,-5,40,35,-5,40,-15,5,-30,30,50,-25,15,FLAT
-15,65,35,100,125,105,120,145,-25,-65,-40,-15,-5,-20,-15,-40,-30,-25,-5,-20,15,-80,-35,-45,FLAT
40,75,0,75,100,125,105,120,-15,5,30,40,-40,-60,-10,25,-20,-15,15,0,-45,-20,25,20,FLAT
-60,5,65,70,75,100,125,105,40,5,10,-60,25,10,40,-20,0,-55,0,-35,20,-10,25,-60,FLAT
-80,20,145,165,180,70,75,100,-135,-85,-70,-80,-195,-135,-230,-215,-155,-130,-220,-275,-170,-125,-190,-235,FLAT
-370,70,375,445,165,180,70,75,-80,-140,-420,-370,-215,-225,-490,-450,-275,-275,-650,-585,-235,-270,-640,-645,FLAT
50,85,50,135,445,165,180,70,-370,-275,35,50,-450,-415,-385,-320,-585,-500,-455,-400,-645,-550,-615,-535,FLAT
-60,20,125,145,135,445,165,180,50,15,5,-60,-320,-260,40,-10,-400,-400,-380,-380,-535,-485,-450,-460,FLAT
-70,0,185,185,145,135,445,165,-60,-10,-50,-70,-10,5,-45,-130,-380,-270,-10,-80,-460,-410,-430,-450,FLAT
-275,60,305,365,185,145,135,445,-70,-155,-335,-275,-130,-165,-385,-345,-80,-150,-380,-405,-450,-425,-345,-355,FLAT
-105,70,145,215,365,185,145,135,-275,-265,-115,-105,-345,-420,-450,-380,-405,-430,-500,-450,-355,-415,-495,-510,FLAT
-130,20,155,175,215,365,185,145,-105,-120,-80,-130,-380,-385,-195,-235,-450,-540,-530,-510,-510,-550,-580,-580,FLAT
-130,155,165,320,175,215,365,185,-130,-120,-265,-130,-235,-240,-345,-260,-510,-505,-460,-365,-580,-660,-795,-640,FLAT
55,115,15,130,320,175,215,365,-130,-95,95,55,-260,-215,-170,-75,-365,-335,-250,-205,-640,-600,-365,-310,FLAT
-190,70,190,260,130,320,175,215,55,-15,-145,-190,-75,-110,-50,-135,-205,-230,-315,-265,-310,-350,-395,-395,FLAT
-160,95,180,275,260,130,320,175,-190,-170,-185,-160,-135,-185,-330,-350,-265,-280,-235,-295,-395,-400,-500,-425,FLAT
30,35,80,115,275,260,130,320,-160,-70,90,30,-350,-240,-95,-130,-295,-255,-240,-320,-425,-350,-145,-265,FLAT
-90,0,300,300,115,275,260,130,30,130,-55,-90,-130,60,35,-60,-320,-110,-150,-220,-265,-125,-295,-410,FLAT
-90,40,195,235,300,115,275,260,-90,-195,-130,-90,-60,-65,-185,-180,-220,-135,-95,-150,-410,-305,-280,-310,FLAT
-85,80,105,185,235,300,115,275,-90,-175,-125,-85,-180,-370,-255,-175,-150,-240,-310,-265,-310,-310,-220,-235,FLAT
-245,10,330,340,185,235,300,115,-85,-20,-175,-245,-175,-195,-300,-330,-265,-390,-430,-420,-235,-260,-485,-510,FLAT
220,225,5,230,340,185,235,300,-245,-105,5,220,-330,-125,-170,-25,-420,-300,-295,-110,-510,-495,-425,-200,FLAT
0,60,90,150,230,340,185,235,220,85,165,0,-25,-20,170,220,-110,-40,-5,-25,-200,-215,-130,-110,FLAT
110,270,85,355,150,230,340,185,0,105,-100,110,220,190,65,110,-25,85,70,330,-110,65,-105,85,FLAT
-10,55,85,140,355,150,230,340,110,-10,205,-10,110,95,105,100,330,180,270,100,85,75,275,320,FLAT
-125,35,190,225,140,355,150,230,-10,-20,-105,-125,100,-30,100,-135,100,75,0,-25,320,160,165,-25,FLAT
45,180,5,185,225,140,355,150,-125,-140,-100,45,-135,-160,-205,-80,-25,-170,0,-90,-25,-65,-100,20,FLAT
-45,60,75,135,185,225,140,355,45,25,75,-45,-80,-115,-25,0,-90,-135,-130,-125,20,-145,75,-135,FLAT
-90,40,155,195,135,185,225,140,-45,-10,-70,-90,0,15,5,-135,-125,-125,-95,-90,-135,-145,-200,-215,FLAT
-115,20,125,145,195,135,185,225,-90,-145,-95,-115,-135,-155,-165,-205,-90,-130,-90,-250,-215,-270,-190,-205,FLAT
115,180,0,180,145,195,135,185,-115,-10,-45,115,-205,-155,-140,0,-250,-165,-210,-90,-205,-140,-135,-135,FLAT
45,120,20,140,100,180,145,195,30,60,20,45,145,95,135,75,30,85,90,190,-60,-60,-5,75,FLAT
15,55,10,65,140,100,180,145,45,5,80,15,75,65,100,60,190,100,215,90,75,90,170,205,FLAT
-5,35,80,115,65,140,100,180,15,65,15,-5,60,70,95,10,90,130,115,55,205,165,230,85,FLAT
110,110,50,160,115,65,140,100,-5,80,35,110,10,145,50,105,55,150,130,120,85,210,150,165,FLAT
55,105,10,115,160,115,65,140,110,15,60,55,105,95,95,165,120,160,110,160,165,165,190,175,FLAT
-65,0,105,105,115,160,115,65,55,30,40,-65,165,45,100,-10,160,125,135,100,175,190,150,95,FLAT
45,60,15,75,105,115,160,115,-65,-45,-15,45,-10,-15,25,-20,100,0,85,35,95,80,120,145,FLAT
-40,5,70,75,75,105,115,160,45,15,15,-40,-20,-30,0,5,35,0,40,-60,145,15,100,-5,FLAT
255,310,115,425,75,75,105,115,-40,300,-50,255,5,315,-35,215,-60,270,-50,260,-5,300,-10,195,FLAT
45,110,70,180,425,75,75,105,255,0,245,45,215,300,195,300,260,315,210,260,195,270,195,305,FLAT
25,70,50,120,180,425,75,75,45,5,65,25,300,5,310,70,260,305,260,325,305,320,275,285,FLAT
35,35,10,45,35,30,40,60,-15,25,15,35,-15,25,10,20,0,15,10,20,40,45,60,35,FLAT
-20,20,25,45,45,35,30,40,35,-5,-5,-20,20,20,10,15,20,20,5,0,35,10,5,0,FLAT
120,130,30,160,45,45,35,30,-20,125,10,120,15,120,5,100,0,145,20,135,0,145,15,120,FLAT
-15,10,45,55,160,45,45,35,120,0,105,-15,100,125,115,105,135,120,110,85,120,145,125,120,FLAT
-35,15,50,65,55,160,45,45,-15,-30,-40,-35,105,-30,65,-50,85,95,75,70,120,90,70,50,FLAT
-20,30,30,60,65,55,160,45,-35,-40,-35,-20,-50,-70,-75,-55,70,-70,30,-70,50,55,40,50,FLAT
-30,30,30,60,60,65,55,160,-20,-30,-30,-30,-55,-70,-65,-50,-70,-100,-105,-85,50,-100,0,-100,FLAT
35,35,20,55,60,60,65,55,-30,25,30,35,-50,-5,0,5,-85,-45,-35,-15,-100,-75,-75,-50,FLAT
-5,20,25,45,55,60,60,65,35,0,10,-5,5,25,40,30,-15,-5,10,0,-50,-45,-25,-20,FLAT
-45,80,55,135,45,55,60,60,-5,-15,-105,-45,30,-15,-95,-50,0,10,-65,-15,-20,-20,-95,-45,FLAT
40,55,80,135,135,45,55,60,-45,65,65,40,-50,50,-40,-5,-15,50,-30,-10,-45,75,0,25,FLAT
125,140,10,150,135,135,45,55,40,55,40,125,-5,120,105,165,-10,105,0,120,25,105,10,115,FLAT
75,120,35,155,150,135,135,45,125,100,95,75,165,155,135,200,120,220,200,240,115,205,95,195,FLAT
70,110,10,120,155,150,135,135,75,45,80,70,200,145,175,145,240,200,215,270,195,265,280,310,FLAT
-90,50,125,175,120,155,150,135,70,25,-30,-90,145,70,50,-20,270,170,145,55,310,225,185,180,FLAT
40,95,20,115,175,120,155,150,-90,-65,-5,40,-20,-40,-35,-50,55,5,45,20,180,105,140,95,FLAT
25,80,25,105,155,115,175,120,-145,-105,-55,25,-105,-115,-105,-120,-195,-180,-110,-80,-125,-155,-140,-170,FLAT
-60,35,70,105,105,155,115,175,25,-15,-15,-60,-120,-120,-70,-35,-80,-130,-120,-180,-170,-195,-125,-140,FLAT
-5,40,45,85,105,105,155,115,-60,-30,-10,-5,-35,-45,-25,-65,-180,-150,-80,-40,-140,-160,-130,-185,FLAT
90,115,30,145,85,105,105,155,-5,75,15,90,-65,45,5,85,-40,30,-10,25,-185,-75,-65,50,FLAT
-15,25,50,75,145,85,105,105,90,5,75,-15,85,80,90,75,25,50,80,70,50,35,65,10,FLAT
-90,25,95,120,75,145,85,105,-15,-45,-90,-90,75,-40,-15,-105,70,35,0,-15,10,5,-10,-20,FLAT
-10,60,30,90,120,75,145,85,-90,-75,-45,-10,-105,-120,-135,-100,-15,-115,-60,-115,-20,-40,-45,-25,FLAT
100,115,5,120,90,120,75,145,-10,75,45,100,-100,0,0,90,-115,-45,-90,0,-25,-40,-15,-15,FLAT
-45,20,55,75,120,90,120,75,100,5,50,-45,90,80,95,55,0,5,50,45,-15,-40,-40,-45,FLAT
-35,10,80,90,75,120,90,120,-45,-10,-25,-35,55,-5,25,-80,45,70,70,20,-45,-5,25,10,FLAT
35,75,10,85,90,75,120,90,-35,-35,-30,35,-80,-45,-55,0,20,-40,-5,-45,10,35,40,55,FLAT
15,70,25,95,85,90,75,120,35,30,20,15,0,-5,-10,50,-45,-15,-35,15,55,-10,15,-30,FLAT
-90,5,110,115,95,85,90,75,15,-5,-25,-90,50,25,-5,-75,15,-10,-35,-40,-30,-20,-60,-75,FLAT
125,145,15,160,115,95,85,90,-90,30,-15,125,-75,25,-40,35,-40,55,-20,50,-75,20,-50,85,FLAT
-285,120,325,445,160,115,95,85,125,25,-260,-285,35,55,-275,-160,50,50,-300,-250,85,80,-280,-235,FLAT
0,50,155,205,445,160,115,95,-285,-170,70,0,-160,-145,-190,-285,-250,-115,-205,-160,-235,-120,-230,-250,FLAT
85,110,50,160,205,445,160,115,0,-20,25,85,-285,-190,95,85,-160,-165,-165,-200,-250,-135,-180,-75,FLAT
-205,250,410,660,160,205,445,160,85,155,-345,-205,85,135,-320,-120,-200,-35,-250,-120,-75,-10,-510,-405,FLAT
130,225,60,285,660,160,205,445,-205,-220,155,130,-120,-65,-190,-75,-120,-85,-165,10,-405,-255,-95,10,FLAT
175,225,145,370,285,660,160,205,130,260,175,175,-75,40,330,305,10,195,-15,100,10,175,10,185,FLAT
-65,205,80,285,370,285,660,160,175,-130,-45,-65,305,130,130,110,100,-90,285,240,185,65,-60,35,FLAT
-225,45,235,280,285,370,285,660,-65,-70,-65,-225,110,-200,-110,-290,240,60,65,-115,35,-160,220,15,FLAT
155,175,75,250,165,280,285,370,75,175,90,155,-150,70,100,230,-215,0,35,5,-40,-130,-10,-60,FLAT
35,110,25,135,250,165,280,285,155,-15,100,35,230,160,190,190,5,55,200,265,-60,-15,135,40,FLAT
30,100,10,110,135,250,165,280,35,15,40,30,190,0,140,65,265,175,230,220,40,70,240,295,FLAT
-110,100,120,220,110,135,250,165,30,0,-110,-110,65,15,-70,-80,220,0,30,-45,295,175,120,110,FLAT
255,310,55,365,220,110,135,250,-110,190,45,255,-80,190,-65,145,-45,205,-25,175,110,190,75,210,FLAT
-115,30,120,150,365,220,110,135,255,-50,165,-115,145,140,210,140,175,140,100,30,210,155,140,60,FLAT
105,120,15,135,150,365,220,110,-115,0,15,105,140,-50,180,-10,30,140,225,245,60,140,115,135,FLAT
-5,70,30,100,135,150,365,220,105,10,45,-5,-10,10,60,100,245,-40,225,-15,135,150,270,240,FLAT
-15,45,70,115,100,135,150,365,-5,25,10,-15,100,35,55,-20,-15,35,70,85,240,-15,235,-30,FLAT
-95,5,120,125,115,100,135,150,-15,-45,-55,-95,-20,-20,-45,-110,85,-10,0,-115,-30,-10,15,-10,FLAT
0,10,70,80,125,115,100,135,-95,-50,-5,0,-110,-95,-60,-95,-115,-70,-50,-110,-10,-60,-5,-115,FLAT
-70,20,90,110,80,125,115,100,0,-50,-80,-70,-95,-100,-85,-70,-110,-145,-140,-165,-115,-120,-130,-180,FLAT
-100,5,150,155,110,80,125,115,-70,-40,-85,-100,-70,-90,-165,-170,-165,-140,-170,-170,-180,-185,-225,-265,FLAT
120,125,5,130,155,110,80,125,-100,-25,0,120,-170,-65,-85,20,-170,-115,-165,-50,-265,-165,-170,-50,FLAT
5,10,45,55,130,155,110,80,120,45,120,5,20,20,120,125,-50,-20,35,25,-50,-70,-45,-45,FLAT
70,75,10,85,55,130,155,110,5,35,5,70,125,80,125,75,25,55,125,195,-45,15,40,95,FLAT
5,20,90,110,85,55,130,155,70,85,60,5,75,120,65,75,195,165,185,80,95,140,185,200,FLAT
35,40,5,45,50,20,60,65,10,25,30,35,10,35,10,45,50,45,60,45,20,60,80,85,FLAT
0,45,5,50,45,50,20,60,35,0,-5,0,45,25,25,35,45,35,5,45,85,45,55,45,FLAT
-15,20,20,40,50,45,50,20,0,0,10,-15,35,0,5,-15,45,25,35,20,45,35,15,30,FLAT
-10,10,45,55,40,50,45,50,-15,15,0,-10,-15,15,10,-25,20,15,5,-25,30,40,35,10,FLAT
20,35,5,40,55,40,50,45,-10,-20,-5,20,-25,-5,-5,10,-25,-5,5,-5,10,-5,0,-5,FLAT
-20,20,25,45,40,55,40,50,20,0,-5,-20,10,-20,-10,0,-5,-5,-10,-10,-5,-5,0,-25,FLAT
10,25,25,50,45,40,55,40,-20,10,5,10,0,10,0,-10,-10,-10,-5,10,-25,5,-5,0,FLAT
10,35,15,50,50,45,40,55,10,0,0,10,-10,10,5,20,10,10,0,0,0,-10,-5,20,FLAT
140,150,5,155,50,50,45,40,10,130,25,140,20,130,25,150,0,140,30,160,20,140,25,140,FLAT
10,55,60,115,155,50,50,45,140,65,105,10,150,195,130,150,160,195,130,160,140,205,135,170,FLAT
20,50,30,80,115,155,50,50,10,-10,25,20,150,55,130,30,160,185,155,170,170,185,155,180,FLAT
-40,15,75,90,80,115,155,50,20,5,-5,-40,30,-5,20,-20,170,60,125,-10,180,190,150,130,FLAT
10,15,70,85,90,80,115,155,-40,5,10,10,-20,10,5,-30,-10,0,30,-10,130,65,135,0,FLAT
-20,20,95,115,85,90,80,115,10,5,-25,-20,-30,10,-15,-10,-10,15,-20,-50,0,5,5,-30,FLAT
80,80,30,110,120,115,85,90,-85,-5,5,80,-105,-70,-65,-5,-95,-65,-90,-25,-135,-60,-80,-15,FLAT
-75,0,80,80,110,120,115,85,80,-25,5,-75,-5,-30,10,5,-25,-95,-60,-80,-15,-90,-85,-100,FLAT
20,20,55,75,80,110,120,115,-75,-5,0,20,5,-30,5,-55,-80,-35,10,25,-100,-100,-60,-60,FLAT
-105,10,140,150,75,80,110,120,20,-20,-95,-105,-55,-25,-95,-85,25,-50,-90,-160,-60,-55,-85,-80,FLAT
35,40,60,100,150,75,80,110,-105,-45,5,35,-85,-65,-90,-70,-160,-70,-90,-50,-80,-95,-85,-125,FLAT
-5,65,15,80,100,150,75,80,35,-50,-30,-5,-70,-95,-25,30,-50,-115,-120,-75,-125,-120,-120,-55,FLAT
-110,15,110,125,80,100,150,75,-5,-15,-60,-110,30,-65,-90,-115,-75,-110,-85,-80,-55,-130,-180,-185,FLAT
20,65,10,75,125,80,100,150,-110,-80,-30,20,-115,-95,-90,-90,-80,-145,-120,-95,-185,-190,-115,-60,FLAT
-95,35,110,145,75,125,80,100,20,5,-65,-95,-90,-75,-95,-75,-95,-90,-155,-185,-60,-140,-185,-190,FLAT
45,60,25,85,145,75,125,80,-95,-40,20,45,-75,-35,-45,-50,-185,-115,-75,-30,-190,-130,-135,-140,FLAT
35,35,25,60,85,145,75,125,45,35,60,35,-50,-5,80,80,-30,0,15,-15,-140,-80,-15,5,FLAT
-195,0,235,235,60,85,145,75,35,15,-160,-195,80,50,-100,-160,-15,10,-80,-115,5,15,-145,-210,FLAT
40,55,25,80,235,60,85,145,-195,-170,-15,40,-160,-155,-175,-155,-115,-120,-115,-120,-210,-160,-95,-75,FLAT
85,90,25,115,80,235,60,85,40,85,50,85,-155,-85,35,125,-120,-70,-125,-70,-75,-35,-65,-35,FLAT
5,25,35,60,115,80,235,60,85,15,70,5,125,100,120,90,-70,-70,105,130,-35,-55,-55,-65,FLAT
25,65,20,85,170,60,115,80,-140,-120,-35,25,-135,-130,-155,-115,-50,-115,-85,-110,-10,-30,-35,-25,FLAT
-30,5,115,120,120,85,170,60,75,60,60,-30,100,140,105,45,-40,20,70,70,-35,10,-50,-70,FLAT
60,70,45,115,120,120,85,170,-30,-10,-5,60,45,50,55,30,70,130,100,105,-70,10,65,130,FLAT
-35,45,45,90,115,120,120,85,60,-35,-10,-35,30,-45,-15,25,105,15,45,-5,130,95,90,70,FLAT
5,90,30,120,90,115,120,120,-35,-10,-40,5,25,-45,-50,-30,-5,-55,-55,30,70,5,5,0,FLAT
120,120,65,185,120,90,115,120,5,155,90,120,-30,145,50,125,30,110,40,90,0,100,35,150,FLAT
-45,85,60,145,185,120,90,115,120,-50,-10,-45,125,105,80,75,90,95,40,80,150,60,30,45,FLAT
20,90,10,100,145,185,120,90,-45,-30,15,20,75,-80,5,-25,80,75,95,95,45,65,55,100,FLAT
-20,35,55,90,100,145,185,120,20,25,35,-20,-25,-5,50,0,95,-55,40,-45,100,100,130,75,FLAT
40,75,30,105,90,100,145,185,-20,15,0,40,0,40,35,20,-45,10,50,40,75,-40,40,-5,FLAT
0,15,45,60,75,105,90,100,15,35,50,0,55,30,75,15,35,45,75,55,55,70,110,35,FLAT
75,100,15,115,60,75,105,90,0,45,-10,75,15,80,40,75,55,75,65,90,35,90,65,130,FLAT
85,130,0,130,115,60,75,105,75,70,55,85,75,115,45,160,90,150,95,160,130,145,120,175,FLAT
160,160,25,185,130,115,60,75,85,185,130,160,160,255,185,245,160,300,175,320,175,335,225,320,FLAT
-25,35,70,105,185,130,115,60,160,20,100,-25,245,205,230,135,320,275,285,220,320,320,275,295,FLAT
-10,25,20,45,105,185,130,115,-25,-60,0,-10,135,-40,100,-35,220,145,230,125,295,215,285,210,FLAT
0,25,30,55,45,105,185,130,-10,10,0,0,-35,-50,0,-10,125,-30,100,-35,210,155,230,125,FLAT
20,60,10,70,55,45,105,185,0,0,-15,20,-10,10,-15,20,-35,-50,-15,10,125,-30,85,-15,FLAT
35,35,20,55,70,55,45,105,20,45,60,35,20,45,45,55,10,55,45,55,-15,-5,45,45,FLAT
0,75,20,95,55,70,55,45,35,0,-40,0,55,45,20,35,55,45,5,55,45,55,5,55,FLAT
-5,25,10,35,95,55,70,55,0,-15,45,-5,35,-15,5,-5,55,30,65,30,55,30,50,50,FLAT
5,55,5,60,35,95,55,70,-5,0,-25,5,-5,-15,20,0,30,-15,-20,0,50,30,40,35,FLAT
-10,55,15,70,60,35,95,55,5,0,-10,-10,0,0,-35,-5,0,-15,10,-10,35,-15,-30,-10,FLAT
85,100,50,150,70,60,35,95,-10,120,40,85,-5,120,30,75,-10,120,5,80,-10,105,50,75,FLAT
35,40,10,50,75,40,55,35,-45,-20,5,35,-65,-35,-45,-10,-30,-35,-30,-30,-10,15,0,5,FLAT
30,45,15,60,50,75,40,55,35,35,25,30,-10,15,30,65,-30,0,-20,20,5,0,-5,0,FLAT
20,45,20,65,60,50,75,40,30,25,20,20,65,60,45,50,20,40,50,85,0,25,0,40,FLAT
-25,15,30,45,65,60,50,75,20,-15,5,-25,50,10,25,-5,85,45,50,25,40,25,55,60,FLAT
70,70,15,85,45,65,60,50,-25,55,15,70,-5,40,20,45,25,65,40,65,60,100,65,95,FLAT
-60,10,75,85,85,45,65,60,70,0,0,-60,45,55,15,10,65,40,20,-15,95,65,40,5,FLAT
-55,30,55,85,100,85,85,45,-60,-70,-55,-55,-120,-135,-135,-115,-50,-135,-135,-175,-75,-80,-120,-105,FLAT
-10,10,55,65,85,100,85,85,-55,-10,10,-10,-115,-80,-45,-65,-175,-145,-125,-125,-105,-145,-125,-185,FLAT
-140,55,150,205,65,85,100,85,-10,-45,-185,-140,-65,-55,-175,-150,-125,-125,-230,-205,-185,-190,-310,-265,FLAT
205,245,20,265,205,65,85,100,-140,75,15,205,-150,30,-170,65,-205,20,-160,55,-265,-50,-215,0,FLAT
-65,10,100,110,265,205,65,85,205,15,170,-65,65,90,185,140,55,45,0,0,0,35,10,-10,FLAT
-70,0,205,205,95,110,265,205,-55,60,-50,-70,-120,-20,-115,-125,85,-5,55,-190,-55,70,70,15,FLAT
-165,5,185,190,205,95,110,265,-70,-185,-170,-165,-125,-125,-220,-235,-190,-205,-285,-290,15,-190,-115,-355,FLAT
175,180,0,180,190,205,95,110,-165,-10,0,175,-235,-195,-170,10,-290,-135,-220,-60,-355,-215,-285,-115,FLAT
-40,35,115,150,140,180,190,205,115,60,50,-40,290,190,220,75,125,180,220,250,55,-5,50,85,FLAT
-35,40,45,85,150,140,180,190,-40,-105,-40,-35,75,-45,10,-75,250,85,180,40,85,75,180,215,FLAT
105,110,45,155,85,150,140,180,-35,105,35,105,-75,0,-5,70,40,60,45,30,215,190,215,145,FLAT
105,150,35,185,155,85,150,140,105,95,65,105,70,200,100,210,30,95,60,175,145,155,110,135,FLAT
50,85,50,135,185,155,85,150,105,65,115,50,210,160,180,155,175,265,215,260,135,160,175,225,FLAT
85,85,30,115,135,185,155,85,50,65,85,85,155,130,200,135,260,225,265,240,225,330,300,345,FLAT
100,115,15,130,115,135,185,155,85,85,70,100,135,150,155,185,240,215,270,235,345,310,335,340,FLAT
-20,25,35,60,130,115,135,185,100,0,70,-20,185,85,140,80,235,150,225,165,340,215,340,215,FLAT
15,45,25,70,60,130,115,135,-20,5,-5,15,80,5,65,-5,165,90,135,95,215,155,220,180,FLAT
0,85,5,90,70,60,130,115,15,-20,-40,0,-5,-15,-45,15,95,-15,25,-5,180,70,95,95,FLAT
-25,25,45,70,90,70,60,130,0,15,35,-25,15,-5,-5,-25,-5,0,-10,-10,95,0,60,-30,FLAT
120,130,20,150,70,90,70,60,-25,95,15,120,-25,110,50,95,-10,90,10,95,-30,95,5,110,FLAT
10,55,10,65,150,70,90,70,120,0,85,10,95,95,100,130,95,110,135,105,110,90,95,105,FLAT
45,110,30,140,65,150,70,90,10,65,-10,45,130,65,75,55,105,160,90,175,105,175,125,150,FLAT
-15,5,65,70,140,65,150,70,45,20,90,-15,55,85,80,30,175,85,165,40,150,180,180,160,FLAT
-60,20,90,110,70,140,65,150,-15,-35,-75,-60,30,-15,15,-75,40,50,5,-30,160,50,90,-20,FLAT
115,135,20,155,110,70,140,65,-60,45,0,115,-75,10,-75,55,-30,30,15,40,-20,95,5,85,FLAT
60,75,30,105,155,110,70,140,115,70,120,60,55,115,120,175,40,80,45,115,85,100,135,100,FLAT
75,95,10,105,105,155,110,70,60,55,55,75,175,125,175,135,115,170,175,250,100,135,100,190,FLAT
-60,60,70,130,105,105,155,110,75,0,-25,-60,135,55,30,15,250,125,150,75,190,170,150,190,FLAT
-55,30,110,140,130,105,105,155,-60,-15,-25,-55,15,-15,-50,-115,75,40,5,-40,190,110,125,20,FLAT
-15,45,55,100,140,130,105,105,-55,-70,-30,-15,-115,-85,-55,-70,-40,-85,-80,-130,20,-30,-25,-55,FLAT
5,5,55,60,100,140,130,105,-15,5,45,5,-70,-65,15,-10,-130,-80,-10,-65,-55,-80,-35,-125,FLAT
95,100,0,100,60,100,140,130,5,40,0,95,-10,45,45,100,-65,-25,15,85,-125,-40,-10,30,FLAT
-35,20,35,55,100,60,100,140,95,0,45,-35,100,40,45,60,85,45,90,65,30,-25,60,50,FLAT
-50,50,60,110,55,100,60,100,-35,-25,-80,-50,60,-25,-35,-85,65,15,-35,10,50,20,10,15,FLAT
-50,20,80,100,110,55,100,60,-50,-30,-20,-50,-85,-55,-100,-100,10,-55,-55,-135,15,-15,-55,-40,FLAT
80,100,10,110,100,110,55,100,-50,10,0,80,-100,-20,-20,30,-135,-45,-100,-20,-40,-45,-55,-55,FLAT
-40,35,65,100,110,100,110,55,80,15,25,-40,30,25,25,40,-20,-5,5,-10,-55,-30,-75,-60,FLAT
-5,100,25,125,100,110,100,110,-40,-45,-70,-5,40,-30,-45,-45,-10,-20,-45,35,-60,-50,-65,-15,FLAT
50,55,15,70,125,100,110,100,-5,40,95,50,-45,-5,25,45,35,10,50,5,-15,20,50,85,FLAT
35,50,0,50,70,125,100,110,50,20,40,35,45,60,135,85,5,15,65,80,85,30,90,40,FLAT
15,45,5,50,50,70,125,100,35,20,20,15,85,40,60,50,80,80,155,100,40,35,85,95,FLAT
-25,25,40,65,50,50,70,125,15,10,-5,-25,50,30,15,-10,100,50,55,25,95,90,150,75,FLAT
-35,10,40,50,90,65,50,50,-50,-65,-25,-35,-75,-85,-70,-85,-60,-75,-75,-110,-25,-55,-55,-95,FLAT
40,60,10,70,50,90,65,50,-35,10,-10,40,-85,-55,-35,5,-110,-75,-80,-45,-95,-65,-85,-70,FLAT
40,55,15,70,70,50,90,65,40,45,45,40,5,55,35,80,-45,-10,10,45,-70,-30,-35,-5,FLAT
5,35,10,45,70,70,50,90,40,0,25,5,80,45,70,45,45,55,60,85,-5,-10,35,50,FLAT
0,15,10,25,45,70,70,50,5,0,20,0,45,0,45,5,85,45,90,45,50,55,80,85,FLAT
-25,5,35,40,50,40,55,35,30,10,20,-25,10,15,15,5,-15,-5,10,-15,-10,-20,-25,-40,FLAT
5,20,5,25,40,50,40,55,-25,-25,-10,5,5,-15,10,-20,-15,-10,5,10,-40,-30,0,-10,FLAT
5,15,15,30,25,40,50,40,5,15,10,5,-20,-10,0,10,10,0,20,-15,-10,5,15,15,FLAT
5,25,10,35,30,25,40,50,5,0,-5,5,10,15,5,10,-15,-10,-5,15,15,0,15,-10,FLAT
20,35,5,40,35,30,25,40,5,15,10,20,10,15,5,25,15,30,15,30,-10,5,5,35,FLAT
-15,20,40,60,40,35,30,25,20,20,0,-15,25,35,10,5,30,35,5,10,35,50,15,15,FLAT
-65,5,65,70,60,40,35,30,-15,-40,-50,-65,5,-20,-50,-80,10,-5,-40,-60,15,-5,-45,-55,FLAT
-15,20,15,35,70,60,40,35,-65,-65,-30,-15,-80,-105,-80,-80,-60,-85,-80,-95,-55,-70,-70,-75,FLAT
40,55,15,70,50,35,70,60,15,25,5,40,0,55,20,55,-65,-10,-10,40,-80,-50,-60,-25,FLAT
40,40,45,85,70,50,35,70,40,70,55,40,55,95,60,80,40,125,75,95,-25,60,45,80,FLAT
5,20,25,45,85,70,50,35,40,-15,25,5,80,55,80,45,95,80,85,85,80,110,100,100,FLAT
30,55,30,85,45,85,70,50,5,35,-5,30,45,20,20,35,85,90,75,75,100,115,80,115,FLAT
120,150,40,190,85,45,85,70,30,130,25,120,35,165,20,150,75,150,45,155,115,220,100,195,FLAT
20,60,45,105,190,85,45,85,120,25,110,20,150,155,135,140,155,190,130,170,195,175,155,175,FLAT
5,30,50,80,105,190,85,45,20,10,35,5,140,35,145,25,170,165,170,145,175,200,165,175,FLAT
-35,50,40,90,80,105,190,85,5,-45,-55,-35,25,-35,-20,-30,145,-10,90,-10,175,120,115,110,FLAT
35,90,5,95,90,80,105,190,-35,0,-5,35,-30,-45,-60,0,-10,-35,-25,5,110,-10,85,25,FLAT
50,55,10,65,55,95,90,80,10,40,30,50,45,65,95,60,10,65,90,95,15,20,35,60,FLAT
70,85,30,115,65,55,95,90,50,90,40,70,60,130,70,120,95,155,135,130,60,155,130,165,FLAT
-40,25,65,90,115,65,55,95,70,-5,20,-40,120,85,60,30,130,125,90,80,165,150,155,90,FLAT
35,35,50,85,90,115,65,55,-40,20,25,35,30,15,45,-5,80,105,85,65,90,145,115,115,FLAT
110,140,15,155,85,90,115,65,35,75,5,110,-5,95,30,145,65,90,50,105,115,180,90,175,FLAT
65,105,10,115,155,85,90,115,110,60,100,65,145,135,105,175,105,155,130,210,175,150,150,170,FLAT
35,55,30,85,115,155,85,90,65,55,85,35,175,115,185,100,210,190,190,210,170,210,215,245,FLAT
120,130,0,130,85,115,155,85,35,90,45,120,100,145,130,155,210,205,230,220,245,280,235,330,FLAT
25,45,20,65,130,85,115,155,120,45,110,25,155,135,155,145,220,190,240,180,330,250,340,245,FLAT
-30,15,65,80,65,130,85,115,25,15,0,-30,145,60,110,-5,180,150,155,115,245,205,240,150,FLAT
10,30,25,55,80,65,130,85,-30,-30,-5,10,-5,-15,-5,-20,115,30,105,5,150,120,150,125,FLAT
0,30,25,55,55,80,65,130,10,0,0,0,-20,-30,-5,10,5,-15,-5,-20,125,30,105,5,FLAT
10,40,15,55,55,55,80,65,0,0,0,10,10,0,0,10,-20,-30,-5,20,5,-15,-5,-10,FLAT
10,75,10,85,55,55,55,80,10,5,-25,10,10,5,-25,20,20,5,-25,20,-10,-25,-30,30,FLAT
-60,30,65,95,85,55,55,55,10,-5,-15,-60,20,0,-40,-50,20,0,-40,-40,30,0,-40,-40,FLAT
80,80,0,80,95,85,55,55,-60,15,30,80,-50,10,15,20,-40,15,-10,30,-40,15,-10,40,FLAT
-70,10,120,130,80,95,85,55,80,50,0,-70,20,65,30,10,30,60,15,-50,40,65,-10,-40,FLAT
5,15,35,50,130,80,95,85,-70,-80,0,5,10,-30,0,-65,-50,-15,30,15,-40,-20,15,-45,FLAT
-25,85,30,115,150,50,130,80,-50,-75,-40,-25,-45,-80,-145,-75,-115,-160,-145,-70,-35,-110,-145,-140,FLAT
60,120,0,120,115,150,50,130,-25,30,25,60,-75,-45,-15,35,-70,-50,-120,-15,-140,-130,-120,-10,FLAT
-10,40,45,85,120,115,150,50,60,35,70,-10,35,65,95,50,-15,-10,55,25,-10,-15,-50,-25,FLAT
60,65,25,90,85,120,115,150,-10,40,35,60,50,75,105,50,25,105,130,110,-25,30,90,85,FLAT
-70,15,85,100,90,85,120,115,60,-10,-20,-70,50,30,15,-10,110,65,85,-20,85,95,110,40,FLAT
-35,15,85,100,100,90,85,120,-70,-35,-35,-35,-10,-45,-55,-105,-20,-5,-20,-45,40,30,50,-55,FLAT
-10,35,65,100,100,100,90,85,-35,-30,-30,-10,-105,-65,-65,-45,-45,-75,-85,-115,-55,-35,-50,-55,FLAT
0,60,25,85,100,100,100,90,-10,-40,-25,0,-45,-70,-55,-10,-115,-105,-90,-45,-55,-115,-110,-115,FLAT
85,155,10,165,85,100,100,100,0,70,-10,85,-10,30,-35,85,-45,0,-65,75,-115,-35,-100,40,FLAT
-75,50,85,135,165,85,100,100,85,0,30,-75,85,70,20,10,75,30,-5,10,40,0,-35,0,FLAT
-25,15,60,75,135,165,85,100,-75,-50,10,-25,10,-50,40,-100,10,20,30,-15,0,-20,5,-15,FLAT
-10,5,60,65,75,135,165,85,-25,-10,0,-10,-100,-60,10,-35,-15,-60,40,-110,-15,10,30,-25,FLAT
-25,10,50,60,65,75,135,165,-10,-35,-30,-25,-35,-45,-30,-35,-110,-95,-20,-60,-25,-95,10,-135,FLAT
-15,0,45,45,60,65,75,135,-25,-20,-5,-15,-35,-55,-35,-40,-60,-65,-35,-50,-135,-115,-25,-75,FLAT
20,35,10,45,45,60,65,75,-15,-15,-15,20,-40,-35,-20,5,-50,-70,-50,-20,-75,-80,-50,-30,FLAT
-25,10,30,40,45,45,60,65,20,-5,0,-25,5,-20,-15,-5,-20,-40,-20,-20,-30,-75,-50,-45,FLAT
-25,35,25,60,40,45,45,60,-25,-30,-50,-25,-5,-35,-50,-50,-20,-50,-65,-30,-45,-70,-70,-45,FLAT
0,0,40,40,60,40,45,45,-25,15,35,0,-50,-15,-15,-25,-30,-20,-15,-50,-45,-35,-30,-30,FLAT
55,60,20,80,40,60,40,45,0,35,-5,55,-25,50,30,55,-50,20,-20,30,-30,15,-20,5,FLAT
-5,5,15,20,20,35,20,35,5,0,0,-5,-5,-15,0,0,-5,5,5,-10,-5,-20,-5,-10,FLAT
-5,5,15,20,20,20,35,20,-5,-5,-5,-5,0,-5,-5,-10,-10,-20,-5,-5,-10,0,0,-15,FLAT
10,25,5,30,20,20,20,35,-5,0,-10,10,-10,-5,-15,5,-5,-5,-15,0,-15,-20,-15,5,FLAT
25,35,0,35,30,20,20,20,10,20,15,25,5,20,5,35,0,15,0,30,5,15,0,25,FLAT
5,10,25,35,35,30,20,20,25,30,30,5,35,50,45,30,30,50,35,40,25,45,30,35,FLAT
-15,20,35,55,35,35,30,20,5,-5,-25,-15,30,25,5,-10,40,45,20,15,35,45,10,25,FLAT
10,20,5,25,55,35,35,30,-15,-20,10,10,-10,-25,-15,-5,15,5,15,0,25,25,30,25,FLAT
-55,20,55,75,25,55,35,35,10,-5,-55,-55,-5,-25,-45,-45,0,-30,-70,-60,25,0,-40,-55,FLAT
5,30,10,40,75,25,55,35,-55,-40,-5,5,-45,-45,-60,-50,-60,-65,-50,-40,-55,-70,-75,-55,FLAT
-40,35,90,125,40,75,25,55,5,40,-45,-40,-50,0,-50,-35,-40,-5,-105,-90,-55,-25,-95,-80,FLAT
10,25,35,60,125,40,75,25,-40,-45,20,10,-35,-5,-25,-30,-90,-45,-30,-25,-80,-50,-85,-80,FLAT
-25,25,30,55,60,125,40,75,10,-30,-25,-25,-30,-75,-5,-15,-25,-35,-50,-55,-80,-75,-55,-50,FLAT
40,45,100,145,65,55,60,125,40,115,35,40,15,150,60,80,25,120,35,55,-15,75,55,65,FLAT
90,110,15,125,145,65,55,60,40,5,25,90,80,120,60,130,55,155,85,170,65,125,60,145,FLAT
25,65,20,85,125,145,65,55,90,30,70,25,130,35,95,115,170,150,130,155,145,185,155,195,FLAT
-5,25,20,45,85,125,145,65,25,-5,35,-5,115,25,105,20,155,30,130,110,195,145,165,150,FLAT
95,145,0,145,45,85,125,145,-5,75,-25,95,20,70,10,90,110,100,80,115,150,105,105,205,FLAT
0,30,30,60,145,45,85,125,95,30,115,0,90,105,90,95,115,100,125,90,205,130,195,115,FLAT
-50,25,55,80,60,145,45,85,0,-25,-45,-50,95,5,70,-50,90,80,45,45,115,75,80,40,FLAT
15,30,35,65,80,60,145,45,-50,-5,10,15,-50,-30,-35,-35,45,0,80,-35,40,75,55,60,FLAT
-5,65,20,85,65,80,60,145,15,-20,-40,-5,-35,-25,-30,10,-35,-50,-75,-40,60,-20,40,-40,FLAT
-20,0,60,60,85,65,80,60,-5,20,45,-20,10,0,5,-25,-40,-5,15,-10,-40,-30,-30,-60,FLAT
30,55,10,65,60,85,65,80,-20,-20,-25,30,-25,0,20,10,-10,-20,-20,5,-60,-25,-10,20,FLAT
55,100,25,125,65,60,85,65,30,70,10,55,10,50,-15,85,5,70,30,65,20,50,-10,60,FLAT
20,65,0,65,125,65,60,85,55,-5,55,20,85,65,65,75,65,45,40,105,60,65,85,85,FLAT
5,40,0,40,65,125,65,60,20,5,30,5,75,0,85,25,105,70,95,80,85,50,70,110,FLAT
-15,30,15,45,40,65,125,65,5,0,-5,-15,25,5,25,-10,80,0,80,10,110,70,90,65,FLAT
35,55,10,65,45,40,65,125,-15,30,10,35,-10,30,5,20,10,35,35,25,65,30,90,45,FLAT
10,25,25,50,65,45,40,65,35,25,40,10,20,55,50,45,25,55,45,30,45,60,75,35,FLAT
-75,40,80,120,60,50,65,45,-45,-45,-105,-75,-35,-65,-135,-120,0,-40,-95,-110,-15,-10,-85,-75,FLAT
-40,30,50,80,120,60,50,65,-75,-70,-30,-40,-120,-115,-135,-115,-110,-135,-165,-160,-75,-110,-125,-150,FLAT
30,55,10,65,80,120,60,50,-40,-10,5,30,-115,-80,-25,-10,-160,-125,-130,-85,-150,-145,-160,-130,FLAT
10,40,20,60,65,80,120,60,30,20,25,10,-10,10,30,40,-85,-60,0,0,-130,-105,-105,-75,FLAT
-60,20,95,115,60,65,80,120,10,15,-40,-60,40,35,-15,-50,0,25,-10,-20,-75,-45,-40,-60,FLAT
15,55,5,60,115,60,65,80,-60,-75,-20,15,-50,-60,-60,-45,-20,-40,-35,-35,-60,-50,-30,-5,FLAT
-15,45,30,75,60,115,60,65,15,10,-5,-15,-45,-65,-25,0,-35,-50,-65,-60,-5,-30,-40,-50,FLAT
25,70,10,80,85,75,60,115,45,15,20,25,30,50,45,70,45,60,40,55,-15,-15,20,70,FLAT
85,90,30,120,80,85,75,60,25,105,65,85,70,120,85,110,55,155,110,155,70,165,105,140,FLAT
-65,15,70,85,120,80,85,75,85,-25,10,-65,110,80,75,20,155,95,95,45,140,130,120,90,FLAT
5,5,50,55,85,120,80,85,-65,-15,15,5,20,-40,25,-60,45,65,90,25,90,80,110,50,FLAT
-15,5,35,40,55,85,120,80,5,-30,-15,-15,-60,-45,0,-10,25,-70,10,-75,50,35,75,10,FLAT
35,80,20,100,40,55,85,120,-15,20,-40,35,-10,-10,-55,20,-75,-25,-40,25,10,-50,-30,-40,FLAT
5,20,80,100,100,40,55,85,35,65,65,5,20,85,25,40,25,55,10,25,-40,40,25,30,FLAT
5,40,15,55,100,100,40,55,5,-60,-15,5,40,5,50,10,25,25,10,45,30,-5,-5,30,FLAT
5,40,15,55,55,100,100,40,5,5,5,5,10,-55,-10,10,45,10,55,15,30,30,15,50,FLAT
60,60,15,75,55,55,100,100,5,60,40,60,10,65,45,65,15,5,30,70,50,70,95,75,FLAT
-25,15,35,50,75,55,55,100,60,-5,20,-25,65,55,60,35,70,60,65,40,75,0,50,45,FLAT
-60,0,65,65,50,75,55,55,-25,-30,-45,-60,35,-35,-25,-85,40,25,15,-25,45,30,20,-20,FLAT
20,25,30,55,65,50,75,55,-60,-15,-5,20,-85,-45,-50,-40,-25,-50,-30,-65,-20,10,10,-5,FLAT
430,435,215,650,60,55,65,50,20,615,25,430,40,635,40,450,-20,620,35,470,-45,590,-10,410,FLAT
150,150,55,205,650,60,55,65,430,-10,435,150,450,605,460,580,470,625,475,600,410,610,470,620,FLAT
355,505,55,560,205,650,60,55,150,355,0,355,580,345,435,505,600,960,460,935,620,980,475,955,FLAT
-70,40,315,355,560,205,650,60,355,190,395,-70,505,545,395,285,935,535,830,435,955,1150,855,865,FLAT
55,60,5,65,40,65,60,35,-30,30,5,55,30,25,25,25,-25,35,30,85,-5,20,-10,30,FLAT
30,50,15,65,65,40,65,60,55,40,40,30,25,70,45,85,85,65,65,55,30,75,70,115,FLAT
30,55,15,70,65,65,40,65,30,30,25,30,85,70,65,60,55,100,70,115,115,95,90,85,FLAT
-15,10,30,40,70,65,65,40,30,0,30,-15,60,30,55,15,115,70,95,45,85,100,100,100,FLAT
-40,10,50,60,40,70,65,65,-15,-20,-40,-40,15,-20,-10,-55,45,10,15,-25,100,50,55,5,FLAT
65,75,10,85,60,40,70,65,-40,25,0,65,-55,5,-40,25,-25,5,-10,10,5,35,15,40,FLAT
130,150,60,210,85,60,40,70,65,180,55,130,25,205,55,195,10,185,15,155,40,185,45,140,FLAT
10,70,0,70,210,85,60,40,130,-50,90,10,195,130,145,140,155,155,145,205,140,135,105,165,FLAT
-95,15,115,130,70,210,85,60,10,20,-40,-95,140,-30,50,-85,205,150,105,45,165,175,105,110,FLAT
45,100,5,105,130,70,210,85,-95,-65,-40,45,-85,-45,-80,-50,45,-95,10,-40,110,85,65,90,FLAT
40,85,30,115,105,130,70,210,45,65,55,40,-50,0,15,85,-40,20,-25,-10,90,-30,65,0,FLAT
-10,65,30,95,175,115,105,130,-165,-150,-70,-10,-125,-175,-155,-175,-80,-110,-100,-135,-175,-175,-140,-90,FLAT
-25,45,65,110,95,175,115,105,-10,10,-5,-25,-175,-140,-75,-35,-135,-165,-160,-200,-90,-100,-105,-160,FLAT
-100,20,135,155,110,95,175,115,-25,-30,-75,-100,-35,-20,-80,-125,-200,-170,-150,-135,-160,-195,-235,-300,FLAT
35,65,35,100,155,110,95,175,-100,-65,-10,35,-125,-95,-85,-65,-135,-85,-90,-90,-300,-235,-160,-100,FLAT
25,80,95,175,100,155,110,95,35,85,10,25,-65,20,0,60,-90,-10,-75,-40,-100,0,-80,-65,FLAT
-10,55,45,100,175,100,155,110,25,-60,15,-10,60,25,25,15,-40,-40,15,50,-65,-70,-60,-50,FLAT
-130,30,130,160,100,175,100,155,-10,-45,-105,-130,15,-105,-90,-140,50,-20,-80,-115,-50,-85,-90,-80,FLAT
5,60,25,85,160,100,175,100,-130,-100,-25,5,-140,-145,-130,-125,-115,-205,-115,-135,-80,-120,-105,-110,FLAT
-5,45,25,70,85,160,100,175,5,-5,10,-5,-125,-105,-15,0,-135,-150,-120,-130,-110,-210,-105,-140,FLAT
-110,5,110,115,70,85,160,100,-5,-25,-70,-110,0,-30,-60,-115,-130,-130,-85,-110,-140,-175,-190,-240,FLAT
-60,20,85,105,115,70,85,160,-110,-85,-75,-60,-115,-110,-145,-170,-110,-115,-135,-175,-240,-215,-160,-170,FLAT
35,40,10,50,100,105,115,70,45,-10,40,35,-15,5,60,80,-125,-80,-15,20,-130,-105,-85,-90,FLAT
0,40,40,80,50,100,105,115,35,30,0,0,80,20,40,35,20,35,60,80,-90,-50,-15,20,FLAT
-15,50,35,85,80,50,100,105,0,-20,-25,-15,35,10,-25,-15,80,0,15,20,20,15,35,65,FLAT
-45,10,70,80,85,80,50,100,-15,-10,-5,-45,-15,-30,-30,-60,20,0,-30,-60,65,-10,10,-25,FLAT
50,60,30,90,80,85,80,50,-45,10,0,50,-60,0,-5,5,-60,-20,-30,-10,-25,10,-30,-10,FLAT
45,95,10,105,90,80,85,80,50,25,10,45,5,35,10,95,-10,25,5,50,-10,5,-20,35,FLAT
80,85,55,140,105,90,80,85,45,125,90,80,95,150,100,125,50,160,100,175,35,150,95,130,FLAT
-150,35,165,200,140,105,90,80,80,-40,-100,-150,125,85,-10,-70,175,110,0,-25,130,120,0,25,FLAT
0,15,70,85,200,140,105,90,-150,-95,20,0,-70,-135,-80,-150,-25,-10,10,-70,25,15,20,-25,FLAT
55,60,15,75,85,200,140,105,0,0,10,55,-150,-95,30,55,-70,-135,-70,-95,-25,-10,20,-15,FLAT
104,113,9,122,75,85,200,140,56,99,52,105,56,99,62,160,-94,4,82,160,-14,-36,-18,10,FLAT
-60,20,95,115,122,75,85,200,104,26,33,-60,160,125,85,45,160,125,95,100,10,30,115,100,FLAT
35,95,10,105,115,122,75,85,-60,-50,-40,35,44,-24,-7,-25,100,75,45,80,100,75,55,135,FLAT
0,65,35,100,105,115,122,75,35,25,30,0,-25,-25,-10,35,79,1,23,-25,135,100,75,80,FLAT
60,90,5,95,100,105,115,122,0,30,35,60,35,55,65,60,-25,5,25,95,79,31,58,35,FLAT
-85,25,100,125,95,100,105,115,60,10,-20,-85,60,40,15,-25,95,65,45,-25,35,15,5,10,FLAT
70,100,40,140,125,95,100,105,-85,10,-5,70,-25,20,-25,-15,-25,50,10,45,10,75,40,45,FLAT
75,90,0,90,140,125,95,100,70,35,85,75,-15,45,80,145,45,55,60,60,45,85,95,120,FLAT
40,60,50,110,90,140,125,95,75,90,70,40,145,125,155,115,60,135,150,185,120,145,130,100,FLAT
0,10,45,55,110,90,140,125,40,-5,50,0,115,85,120,40,185,120,205,115,100,130,200,185,FLAT
-130,65,135,200,55,110,90,140,0,-40,-185,-130,40,-45,-135,-130,115,45,-65,-90,185,80,20,-15,FLAT
30,95,15,110,200,55,110,90,-130,-90,0,30,-130,-130,-185,-100,-90,-135,-135,-100,-15,-45,-65,-60,FLAT
-10,60,60,120,110,200,55,110,30,35,25,-10,-100,-55,25,20,-100,-95,-160,-110,-60,-100,-110,-110,FLAT
60,65,5,70,120,110,200,55,-10,5,55,60,20,40,80,50,-110,-50,80,80,-110,-90,-105,-50,FLAT
-25,25,35,60,70,120,110,200,60,5,15,-25,50,10,70,35,80,45,95,25,-50,-45,95,55,FLAT
-90,0,130,130,175,60,70,120,-175,-135,-90,-90,-200,-170,-240,-265,-140,-165,-225,-290,-150,-160,-170,-230,FLAT
70,80,30,110,130,175,60,70,-90,-30,-10,70,-265,-165,-100,-20,-290,-200,-250,-195,-230,-195,-235,-220,FLAT
-70,50,70,120,110,130,175,60,70,-30,-40,-70,-20,-60,-50,0,-195,-195,-140,-90,-220,-230,-290,-265,FLAT
65,80,5,85,120,110,130,175,-70,0,35,65,0,-30,-5,-5,-90,-60,-15,65,-265,-195,-105,-25,FLAT
-85,5,100,105,85,120,110,130,65,10,-10,-85,-5,10,25,-20,65,-20,-15,-90,-25,-50,-25,-20,FLAT
-90,45,100,145,105,85,120,110,-85,-90,-130,-90,-20,-80,-140,-175,-90,-80,-105,-110,-20,-110,-145,-180,FLAT
-160,140,180,320,145,105,85,120,-90,-80,-255,-160,-175,-170,-385,-250,-110,-160,-395,-335,-180,-160,-360,-270,FLAT
50,55,0,55,25,50,55,50,15,50,20,50,40,40,35,65,10,55,55,90,35,55,50,60,FLAT
5,40,5,45,55,25,50,55,50,10,20,5,65,60,40,55,90,50,55,70,60,65,75,95,FLAT
10,30,5,35,45,55,25,50,5,10,20,10,55,20,40,15,70,70,60,65,95,60,75,80,FLAT
-10,0,20,20,35,45,55,25,10,5,20,-10,15,15,40,0,65,25,60,5,80,75,80,55,FLAT
10,35,10,45,35,20,35,45,-15,0,-10,10,-25,-15,-40,-5,-15,-10,-20,-15,-10,0,0,-5,FLAT
-5,10,40,50,90,45,35,20,-50,-20,20,-5,-40,-25,-30,-55,-55,-25,-40,-45,-65,-40,-70,-60,FLAT
-45,0,80,80,50,90,45,35,-5,-5,-35,-45,-55,-25,-15,-50,-45,-30,-65,-100,-60,-30,-75,-90,FLAT
70,85,15,100,80,50,90,45,-45,5,-15,70,-50,0,-50,25,-100,-20,-30,20,-90,-25,-80,-30,FLAT
-35,30,45,75,100,80,50,90,70,-5,20,-35,25,0,5,35,20,-5,-30,-10,-30,-25,-10,-15,FLAT
45,50,5,55,75,100,80,50,-35,5,25,45,35,0,45,10,-10,5,30,80,-15,0,-5,35,FLAT
-45,15,75,90,55,75,100,80,45,25,-10,-45,10,30,15,0,80,25,35,-35,35,30,20,35,FLAT
-355,85,385,470,90,55,75,100,-45,-45,-425,-355,0,-20,-435,-400,-35,-15,-410,-355,35,-20,-390,-390,FLAT
-55,140,140,280,470,90,55,75,-355,-300,-110,-55,-400,-345,-535,-410,-355,-320,-545,-455,-390,-315,-520,-410,FLAT
-150,40,220,260,280,470,90,55,-55,-70,-50,-150,-410,-370,-160,-205,-455,-415,-585,-560,-410,-390,-595,-605,FLAT
80,100,15,115,260,280,470,90,-150,-125,20,80,-205,-195,-30,-70,-560,-495,-140,-125,-605,-540,-565,-480,FLAT
60,120,10,130,115,260,280,470,80,55,40,60,-70,-70,60,140,-125,-140,10,-10,-480,-440,-100,-65,FLAT
5,55,45,100,130,115,260,280,60,40,70,5,140,95,110,65,-10,-30,130,145,-65,-100,80,-5,FLAT
-270,5,280,285,100,130,115,260,5,-35,-220,-270,65,5,-150,-265,145,60,-110,-205,-5,-65,-90,-125,FLAT
-335,45,335,380,285,100,130,115,-270,-280,-375,-335,-265,-315,-595,-605,-205,-275,-525,-600,-125,-220,-485,-540,FLAT
25,25,105,130,380,285,100,130,-335,-205,45,25,-605,-485,-330,-310,-600,-520,-550,-580,-540,-480,-480,-575,FLAT
80,150,60,210,130,380,285,100,25,35,-45,80,-310,-170,0,105,-580,-450,-375,-230,-575,-485,-595,-500,FLAT
0,95,20,115,210,130,380,285,80,-40,55,0,105,-5,10,80,-230,-210,55,105,-500,-490,-320,-230,FLAT
-85,30,130,160,115,210,130,380,0,25,-20,-85,80,-15,35,-85,105,20,-10,-5,-230,-185,35,20,FLAT
65,215,5,220,160,115,210,130,-85,-60,-120,65,-85,-35,-140,-20,-5,-75,-85,-20,20,-40,-130,60,FLAT
110,125,15,140,220,160,115,210,65,120,200,110,-20,60,80,175,-20,85,60,90,60,45,115,90,FLAT
-65,15,90,105,140,220,160,115,110,10,45,-65,175,130,245,45,90,70,125,110,90,95,105,25,FLAT
-5,65,10,75,105,140,220,160,-65,-85,-55,-5,45,-75,-10,-70,110,45,190,40,25,-15,70,105,FLAT
-60,95,65,160,75,105,140,220,-5,-5,-90,-60,-70,-90,-145,-65,40,-80,-100,-130,105,40,100,-20,FLAT
50,100,15,115,160,75,105,140,-60,0,45,50,-65,-5,-45,-10,-130,-90,-100,-15,-20,-80,-55,-80,FLAT
85,85,60,145,115,160,75,105,50,130,100,85,-10,130,145,135,-15,125,55,75,-80,40,0,70,FLAT
35,115,30,145,145,115,160,75,85,5,5,35,135,135,105,120,75,135,150,170,70,130,60,110,FLAT
-45,20,85,105,145,145,115,160,35,10,50,-45,120,15,55,-10,170,145,155,75,110,145,200,125,FLAT
185,220,0,220,105,145,145,115,-45,100,-15,185,-10,110,35,140,75,115,40,175,125,245,140,260,FLAT
-55,50,80,130,220,105,145,145,185,25,115,-55,140,125,100,130,175,135,150,85,260,140,155,120,FLAT
-10,155,55,210,130,220,105,145,-55,-35,-115,-10,130,-10,0,-65,85,90,-15,120,120,100,35,75,FLAT
35,85,70,155,210,130,220,105,-10,50,105,35,-65,15,-10,25,120,40,105,-30,75,140,90,155,FLAT
-45,65,55,120,155,210,130,220,35,-60,-25,-45,25,-10,80,-10,-30,-45,-35,-20,155,-20,80,-75,FLAT
20,45,30,75,120,155,210,130,-45,-5,40,20,-10,-65,15,-25,-20,-15,120,10,-75,-50,5,0,FLAT
-80,5,110,115,75,120,155,210,20,0,-40,-80,-25,-5,0,-60,10,-65,-25,-105,0,-15,80,-70,FLAT
-65,15,110,125,115,75,120,155,-80,-65,-75,-65,-60,-65,-115,-145,-105,-70,-75,-125,-70,-130,-100,-170,FLAT
40,60,10,70,125,115,75,120,-65,-60,-5,40,-145,-125,-80,-25,-125,-125,-120,-105,-170,-130,-80,-85,FLAT
20,50,50,100,70,125,115,75,40,60,30,20,-25,0,25,60,-105,-65,-50,-5,-85,-65,-90,-85,FLAT
120,135,25,160,100,70,125,115,20,95,35,120,60,155,65,140,-5,95,60,180,-85,30,-15,115,FLAT
-20,35,75,110,160,100,70,125,120,30,80,-20,140,125,115,100,180,185,145,120,115,125,140,160,FLAT
-10,45,40,85,110,160,100,70,-20,-45,-20,-10,100,-15,60,-30,120,80,95,90,160,140,125,110,FLAT
5,75,15,90,85,110,160,100,-10,-20,-25,5,-30,-65,-45,-5,90,-35,35,-25,110,60,70,95,FLAT
-15,15,60,75,90,85,110,160,5,30,45,-15,-5,10,20,-10,-25,-35,0,-20,95,-5,80,-40,FLAT
15,35,30,65,75,90,85,110,-15,-15,-5,15,-10,15,40,0,-20,-5,15,5,-40,-50,-5,-5,FLAT
45,65,10,75,65,75,90,85,15,25,15,45,0,10,10,60,5,40,55,45,-5,20,30,50,FLAT
15,30,25,55,75,65,75,90,45,30,50,15,60,55,65,60,45,40,60,75,50,70,105,60,FLAT
-35,20,50,70,55,75,65,75,15,-10,-25,-35,60,20,25,-20,75,45,40,25,60,30,35,40,FLAT
-60,15,65,80,70,55,75,65,-35,-45,-55,-60,-20,-55,-80,-95,25,-25,-30,-80,40,0,-15,-35,FLAT
-10,0,35,35,80,70,55,75,-60,-40,5,-10,-95,-85,-50,-70,-80,-95,-75,-105,-35,-65,-25,-90,FLAT
70,75,0,75,35,80,70,55,-10,35,-5,70,-70,-5,0,60,-105,-50,-55,0,-90,-60,-80,-35,FLAT
-10,10,25,35,75,35,80,70,70,15,55,-10,60,50,50,60,0,10,55,50,-35,-35,0,-10,FLAT
-10,15,35,50,60,20,20,65,35,5,15,-10,30,40,10,25,25,40,10,20,80,45,60,15,FLAT
5,25,0,25,50,60,20,20,-10,-30,-5,5,25,-25,10,-5,20,10,5,30,15,10,5,25,FLAT
-45,5,50,55,25,25,50,60,-15,-15,-45,-45,-10,-10,-40,-60,-20,-40,-45,-55,15,-35,-30,-65,FLAT
20,40,0,40,55,25,25,50,-45,-30,-15,20,-60,-45,-60,-25,-55,-40,-55,-40,-65,-70,-60,-35,FLAT
-20,10,30,40,40,55,25,25,20,10,10,-20,-25,-20,-5,0,-40,-35,-50,-45,-35,-30,-45,-60,FLAT
5,25,15,40,40,40,55,25,-20,-10,-10,5,0,0,0,-15,-45,-30,-15,5,-60,-45,-60,-40,FLAT
-10,10,15,25,40,40,40,55,5,-10,5,-10,-15,-20,-5,-5,5,-10,5,-25,-40,-40,-10,-5,FLAT
0,20,55,75,25,40,40,40,-10,40,-10,0,-5,30,-5,-10,-25,20,-15,-5,-5,30,-5,-25,FLAT
-40,15,45,60,75,25,40,40,0,-50,-35,-40,-10,-10,-45,-40,-5,-20,-40,-50,-25,-30,-50,-45,FLAT
-40,60,50,110,60,75,25,40,-40,-35,-85,-40,-40,-85,-120,-80,-50,-45,-130,-80,-45,-55,-125,-90,FLAT
-20,45,20,65,110,60,75,25,-40,-50,-5,-20,-80,-85,-90,-60,-80,-135,-125,-100,-90,-95,-135,-100,FLAT
80,85,30,115,65,110,60,75,-20,90,40,80,-60,40,35,60,-100,5,-50,20,-100,-45,-85,-20,FLAT
50,60,135,195,115,65,110,60,80,155,75,50,60,245,115,130,20,195,110,110,-20,160,25,70,FLAT
0,50,30,80,70,195,115,65,-65,-35,-45,0,-15,-170,-55,-65,65,-15,20,-15,45,75,60,65,FLAT
-100,70,100,170,80,70,195,115,0,-30,-120,-100,-65,-65,-165,-100,-15,-200,-175,-165,65,-45,-100,-115,FLAT
50,145,35,180,180,170,80,70,120,40,40,50,20,105,95,170,20,75,-25,70,-45,40,-70,70,FLAT
-10,45,45,90,180,180,170,80,50,0,90,-10,170,40,130,40,70,105,185,160,70,75,65,60,FLAT
-15,25,25,50,90,180,180,170,-10,-35,5,-15,40,-35,95,-25,160,5,135,25,60,70,190,145,FLAT
-75,5,90,95,50,90,180,180,-15,-10,-55,-75,-25,-45,-50,-90,25,-45,40,-100,145,-5,80,-50,FLAT
40,65,60,125,95,50,90,180,-75,10,-20,40,-90,0,-75,-35,-100,-35,-70,-50,-50,-35,20,-60,FLAT
-55,5,70,75,125,95,50,90,40,-45,5,-55,-35,-35,-15,-15,-50,-45,-70,-90,-60,-80,-65,-105,FLAT
85,85,35,120,75,125,95,50,-55,50,5,85,-15,5,10,30,-90,15,-10,70,-105,5,-65,-5,FLAT
5,30,30,60,120,75,125,95,85,0,60,5,30,50,65,90,70,5,70,35,-5,15,50,75,FLAT
-15,30,25,55,60,120,75,125,5,-20,-15,-15,90,-20,45,-10,35,30,50,75,75,-15,55,20,FLAT
0,35,10,45,55,60,120,75,-15,-15,-5,0,-10,-35,-20,-15,75,-35,40,-10,20,15,45,75,FLAT
30,35,15,50,45,55,60,120,0,35,30,30,-15,20,25,30,-10,0,10,15,75,0,70,20,FLAT
25,35,20,55,50,45,55,60,30,30,25,25,30,65,55,55,15,50,50,55,20,30,35,40,FLAT
0,5,75,80,55,50,45,55,25,55,30,0,55,85,55,25,55,120,85,55,40,105,80,55,FLAT
45,45,40,85,80,55,50,45,0,10,5,45,25,65,35,45,55,95,60,70,55,130,90,100,FLAT
-35,25,95,120,85,80,55,50,45,20,-15,-35,45,30,-10,10,70,85,20,10,100,115,45,35,FLAT
20,35,30,65,120,85,80,55,-35,-45,10,20,10,-25,-5,-15,10,-15,0,30,35,40,30,30,FLAT
45,100,20,120,65,120,85,80,20,35,-20,45,-15,-10,-10,65,30,10,-25,30,30,20,-20,75,FLAT
-40,5,65,70,120,65,120,85,45,5,55,-40,65,40,35,5,30,-5,45,25,75,15,30,-10,FLAT
-10,50,25,75,70,120,65,120,-40,-50,-55,-10,5,-45,0,-50,25,-10,-20,-5,-10,-55,-10,15,FLAT
35,65,30,95,75,70,120,65,-10,40,20,35,-50,-10,-35,25,-5,-5,20,-15,15,30,0,30,FLAT
180,195,0,195,95,75,70,120,35,150,50,180,25,190,70,215,-15,140,15,205,30,145,70,165,FLAT
-20,105,25,130,195,95,75,70,180,5,70,-20,215,155,120,160,205,195,140,195,165,145,85,185,FLAT
-80,30,80,110,130,195,95,75,-20,-25,-5,-80,160,-20,65,-100,195,130,115,80,185,170,135,115,FLAT
5,30,70,100,110,130,195,95,-80,-5,5,5,-100,-30,0,-75,80,-25,70,-95,115,125,120,85,FLAT
10,75,30,105,100,110,130,195,5,-30,-35,10,-75,-35,-30,15,-95,-60,-35,-65,85,-55,35,-85,FLAT
-60,35,75,110,105,100,110,130,10,-15,-20,-60,15,-45,-55,-50,-65,-50,-50,-45,-85,-75,-55,-125,FLAT
15,60,15,75,110,105,100,110,-60,-45,-10,15,-50,-60,-30,-45,-45,-90,-65,-35,-125,-95,-60,-30,FLAT
25,65,20,85,75,110,105,100,15,30,20,25,-45,-15,10,40,-35,-30,-10,-20,-30,-60,-45,-10,FLAT
-20,25,20,45,85,75,110,105,25,-20,20,-20,40,10,40,5,-20,-35,30,20,-10,-50,10,-40,FLAT
45,65,0,65,45,85,75,110,-20,25,5,45,5,5,25,25,20,35,45,50,-40,-10,35,65,FLAT
15,25,20,45,65,45,85,75,45,35,55,15,25,60,60,60,50,40,80,40,65,70,100,65,FLAT
5,20,35,55,45,65,45,85,15,20,10,5,60,55,65,20,40,80,70,65,65,60,90,45,FLAT
55,55,10,65,55,45,65,45,5,30,20,55,20,50,30,60,65,85,85,75,45,110,90,120,FLAT
-50,15,60,75,65,55,45,65,55,0,-10,-50,60,30,10,5,75,50,20,10,120,85,75,25,FLAT
20,40,5,45,75,65,55,45,-50,-35,-5,20,5,-35,-15,-30,10,-5,5,25,25,15,15,30,FLAT
-30,10,50,60,45,75,65,55,20,15,0,-30,-30,-20,-5,-10,25,-20,-15,-60,30,10,5,-5,FLAT
40,60,5,65,60,45,75,65,-30,-5,-10,40,-10,10,-10,10,-60,-25,-15,30,-5,-25,-25,-20,FLAT
-10,15,20,35,65,60,45,75,40,5,35,-10,10,0,25,30,30,15,25,0,-20,-20,20,20,FLAT
30,35,20,55,35,65,60,45,-10,30,10,30,30,35,45,20,0,30,35,60,20,45,35,30,FLAT
-5,25,5,30,15,35,40,70,-10,-10,-25,-5,-5,-15,-10,-15,15,-25,-15,-10,5,-25,15,10,FLAT
-30,5,30,35,30,15,35,40,-5,-5,-10,-30,-15,-15,-35,-35,-10,-20,-20,-45,10,-30,-25,-40,FLAT
-10,10,25,35,35,30,15,35,-30,-15,-15,-10,-35,-20,-25,-40,-45,-30,-50,-45,-40,-35,-35,-55,FLAT
30,40,10,50,35,35,30,15,-10,15,0,30,-40,0,-15,20,-45,-5,-25,-10,-55,-15,-50,-15,FLAT
-15,10,25,35,50,35,35,30,30,0,15,-15,20,15,15,15,-10,0,0,5,-15,-5,-10,-25,FLAT
-20,15,25,40,35,50,35,35,-15,-20,-25,-20,15,-20,-10,-35,5,-5,-10,-5,-25,-20,-25,-15,FLAT
-25,20,30,50,40,35,50,35,-20,-20,-30,-25,-35,-40,-55,-45,-5,-40,-40,-60,-15,-25,-40,-30,FLAT
35,35,0,35,50,40,35,50,-25,5,20,35,-45,-15,-10,10,-60,-35,-35,-10,-30,-35,-20,-25,FLAT
-10,15,60,75,35,50,40,35,35,50,10,-10,10,55,30,25,-10,35,0,0,-25,15,-25,-20,FLAT
45,60,20,80,75,35,50,40,-10,5,0,45,25,55,10,35,0,60,30,70,-20,40,0,45,FLAT
10,20,30,50,80,75,35,50,45,20,50,10,35,25,50,55,70,75,60,45,45,80,80,80,FLAT
-60,0,90,90,50,80,75,35,10,0,-40,-60,55,20,10,-50,45,25,10,-5,80,75,20,-15,FLAT
-15,5,90,95,90,50,80,75,-60,-15,-20,-15,-50,-15,-60,-75,-5,5,-10,-65,-15,10,-10,-20,FLAT
75,75,40,115,95,90,50,80,-15,25,5,75,-75,10,-15,60,-65,10,-55,0,-20,30,-5,10,FLAT
85,115,40,155,115,95,90,50,75,85,45,85,60,110,50,160,0,95,30,145,10,95,-10,85,FLAT
35,55,30,85,155,115,95,90,85,25,95,35,160,110,140,120,145,135,145,195,85,120,125,180,FLAT
-75,10,135,145,85,155,115,95,35,30,-30,-75,120,55,65,-40,195,140,110,45,180,165,115,120,FLAT
15,25,20,45,145,85,155,115,-75,-100,0,15,-40,-70,-30,-60,45,-45,65,-25,120,40,110,60,FLAT
-30,5,45,50,45,145,85,155,15,-5,-10,-30,-60,-105,-10,-15,-25,-75,-40,-90,60,-50,55,-55,FLAT
-30,30,45,75,50,45,145,85,-30,-30,-55,-30,-15,-35,-65,-60,-90,-135,-65,-45,-55,-105,-95,-120,FLAT
-35,10,65,75,75,50,45,145,-30,-15,-15,-35,-60,-45,-70,-65,-45,-50,-80,-95,-120,-150,-80,-80,FLAT
0,20,80,100,75,75,50,45,-35,15,-10,0,-65,0,-25,-35,-95,-30,-80,-65,-80,-35,-90,-95,FLAT
-25,20,30,50,85,100,75,75,30,-35,0,-25,30,-45,5,5,-5,-30,-5,5,-35,-45,-20,-30,FLAT
35,50,65,115,50,85,100,75,-25,70,5,35,5,35,5,10,5,25,10,40,-30,40,0,40,FLAT
20,40,40,80,115,50,85,100,35,-5,30,20,10,65,35,55,40,30,35,30,40,20,40,60,FLAT
95,105,10,115,80,115,50,85,20,65,30,95,55,60,60,115,30,130,65,150,60,95,65,125,FLAT
-40,0,55,55,115,80,115,50,95,5,65,-40,115,70,95,55,150,65,125,75,125,135,130,110,FLAT
-10,65,15,80,55,115,80,115,-40,-50,-75,-10,55,-45,-10,-50,75,20,20,45,110,15,50,65,FLAT
60,85,0,85,80,55,115,80,-10,45,40,60,-50,-5,-35,50,45,0,30,10,65,65,60,105,FLAT
0,30,15,45,85,80,55,115,60,15,55,0,50,60,95,60,10,10,20,50,105,15,85,10,FLAT
-20,0,95,95,45,85,80,55,0,60,10,-20,60,75,65,-20,50,120,105,40,10,70,30,30,FLAT
45,55,30,85,95,45,85,80,-20,-20,-10,45,-20,40,0,25,40,55,55,25,30,100,95,85,FLAT
90,105,25,130,85,95,45,85,45,85,40,90,25,65,30,135,25,125,40,115,85,140,95,115,FLAT
10,35,40,75,130,85,95,45,90,25,80,10,135,110,120,100,115,90,110,145,115,150,120,125,FLAT
-10,0,65,65,75,130,85,95,10,15,25,-10,100,40,105,0,145,125,145,90,125,105,135,135,FLAT
-55,35,55,90,110,65,75,130,-10,-20,0,-55,-20,-75,-100,-65,-10,-60,-75,-75,80,-35,5,-65,FLAT
-60,5,80,85,90,110,65,75,-55,-35,-30,-60,-65,-55,-30,-115,-75,-110,-130,-125,-65,-95,-105,-135,FLAT
0,50,35,85,85,90,110,65,-60,-45,-45,0,-115,-80,-75,-60,-125,-100,-75,-115,-135,-155,-175,-125,FLAT
-40,15,65,80,85,85,90,110,0,-10,-5,-40,-60,-55,-50,-40,-115,-90,-80,-100,-125,-110,-80,-155,FLAT
-25,50,50,100,80,85,85,90,-40,-40,-60,-25,-40,-50,-65,-65,-100,-95,-110,-65,-155,-130,-140,-125,FLAT
65,160,5,165,120,100,80,85,50,35,-10,65,25,70,5,115,-15,30,-55,90,-15,20,-60,50,FLAT
-10,0,90,90,165,120,100,80,65,75,150,-10,115,110,140,55,90,145,155,105,50,105,95,80,FLAT
70,75,5,80,90,165,120,100,-10,-15,-5,70,55,60,145,60,105,95,135,125,80,130,150,175,FLAT
30,50,10,60,80,90,165,120,70,35,55,30,60,20,50,100,125,95,200,90,175,130,190,155,FLAT
0,10,40,50,60,80,90,165,30,30,40,0,100,65,95,30,90,50,90,100,155,125,240,90,FLAT
10,40,20,60,50,60,80,90,0,-10,-20,10,30,20,20,10,100,55,75,40,90,40,70,110,FLAT
-50,65,60,125,60,50,60,80,10,-10,-75,-50,10,-20,-95,-40,40,10,-55,-40,110,45,0,-10,FLAT
10,15,40,55,125,60,50,60,-50,-10,60,10,-40,-20,-15,-40,-40,-30,-35,-30,-10,0,5,-30,FLAT
-25,5,35,40,55,125,60,50,10,-30,-15,-25,-40,-40,45,-15,-30,-50,-30,-65,-30,-60,-50,-55,FLAT
55,55,10,65,40,55,125,60,-25,30,5,55,-15,0,-10,30,-65,-10,50,40,-55,-20,-25,-10,FLAT
-30,25,55,80,65,40,55,125,55,15,0,-30,30,45,5,25,40,15,-10,0,-10,5,50,10,FLAT
35,45,5,50,80,65,40,55,-30,-15,15,35,25,0,15,5,0,30,20,60,10,0,5,35,FLAT
-15,5,25,30,50,80,65,40,35,5,25,-15,5,-10,40,20,60,5,40,-10,35,35,45,45,FLAT
-35,0,45,45,30,50,80,65,-15,-15,-30,-35,20,-10,-5,-50,-10,-25,10,-15,45,-10,10,-45,FLAT
-15,0,15,15,30,30,25,45,15,0,15,-15,10,5,20,0,0,-10,0,-5,-20,-35,-5,-15,FLAT
-5,25,5,30,15,30,30,25,-15,-15,-30,-5,0,-15,-15,-20,-5,-10,-10,-5,-15,-25,-30,-10,FLAT
65,75,15,90,30,15,30,30,-5,75,15,65,-20,60,-15,60,-5,60,0,45,-10,65,5,60,FLAT
-40,0,55,55,90,30,15,30,65,0,35,-40,60,75,50,25,45,60,20,20,60,60,35,5,FLAT
-10,5,25,30,55,90,30,15,-40,-40,-15,-10,25,-40,20,-50,20,35,35,15,5,20,5,10,FLAT
0,10,35,45,30,55,90,30,-10,10,-5,0,-50,-30,-20,-10,15,-30,15,-50,10,45,30,15,FLAT
-20,0,45,45,45,30,55,90,0,-10,-10,-20,-10,0,-15,-20,-50,-40,-30,-30,15,-40,5,-70,FLAT
5,10,30,40,45,45,30,55,-20,-10,-5,5,-20,-20,-15,-15,-30,-10,-20,-15,-70,-50,-35,-25,FLAT
-40,5,65,70,40,45,45,30,5,-5,-35,-40,-15,-15,-40,-35,-15,-25,-50,-55,-25,-15,-55,-55,FLAT
0,90,25,115,70,40,45,45,-40,-40,-85,0,-35,-45,-120,-40,-55,-55,-125,-35,-55,-65,-135,-55,FLAT
-50,5,60,65,115,70,40,45,0,-15,35,-50,-40,-55,-50,-50,-35,-60,-85,-90,-55,-70,-90,-85,FLAT
15,50,15,65,65,115,70,40,-50,-30,-30,15,-50,-45,5,-35,-90,-85,-80,-35,-85,-90,-115,-75,FLAT
-55,0,85,85,65,65,115,70,15,15,-5,-55,-35,-15,-35,-40,-35,-30,0,-90,-75,-70,-85,-90,FLAT
10,60,20,80,85,65,65,115,-55,-55,-50,10,-40,-40,-55,-45,-90,-70,-85,-30,-90,-85,-50,-80,FLAT
30,85,0,85,105,80,85,65,90,15,35,30,100,100,95,120,45,45,45,130,60,60,40,75,FLAT
10,45,5,50,85,105,80,85,30,15,50,10,120,30,85,40,130,115,145,130,75,60,95,140,FLAT
0,45,5,50,50,85,105,80,10,0,0,0,40,15,50,10,130,30,85,40,140,115,145,130,FLAT
-15,25,15,40,50,50,85,105,0,-5,5,-15,10,-5,5,-15,40,10,55,-5,130,25,90,25,FLAT
30,80,10,90,40,50,50,85,-15,25,-25,30,-15,20,-20,15,-5,20,-20,15,25,35,30,25,FLAT
-55,65,60,125,90,40,50,50,30,-5,-40,-55,15,20,-65,-25,15,15,-60,-40,25,15,-60,-40,FLAT
60,70,20,90,125,90,40,50,-55,20,55,60,-25,15,15,5,-40,40,-10,35,-40,35,-5,20,FLAT
45,50,20,70,90,125,90,40,60,45,65,45,5,65,120,105,35,60,80,50,20,85,55,80,FLAT
100,105,20,125,70,90,125,90,45,100,45,100,105,145,110,145,50,165,165,205,80,160,125,150,FLAT
65,90,30,120,125,70,90,125,100,75,80,65,145,175,125,165,205,220,190,210,150,240,245,270,FLAT
10,55,0,55,120,125,70,90,65,-20,45,10,165,55,125,75,210,155,170,175,270,200,235,220,FLAT
-55,15,70,85,55,120,125,70,10,15,-15,-55,75,-5,30,-45,175,70,110,20,220,170,155,120,FLAT
-5,40,25,65,85,55,120,125,-55,-50,-30,-5,-45,-35,-45,-60,20,-55,0,-50,120,20,80,15,FLAT
25,60,10,70,65,85,55,120,-5,10,5,25,-60,-40,-25,20,-50,-25,-40,-35,15,-45,5,-25,FLAT
-15,35,40,75,70,65,85,55,25,15,10,-15,20,25,15,10,-35,-25,-15,5,-25,-10,-30,-50,FLAT
50,60,10,70,75,70,65,85,-15,20,25,50,10,35,35,35,5,45,40,60,-50,-5,10,55,FLAT
80,80,30,110,70,75,70,65,50,100,60,80,35,120,85,130,60,135,95,115,55,145,100,140,FLAT
-80,15,130,145,145,110,70,75,-140,-90,-90,-80,-60,-120,-155,-220,-10,-20,-95,-140,-25,0,-70,-90,FLAT
15,95,0,95,145,145,110,70,-80,-115,-65,15,-220,-205,-155,-65,-140,-235,-220,-205,-90,-135,-160,-125,FLAT
-30,25,70,95,95,145,145,110,15,40,40,-30,-65,-75,-25,-15,-205,-165,-115,-95,-125,-195,-180,-235,FLAT
80,80,25,105,95,95,145,145,-30,35,25,80,-15,75,65,50,-95,-40,0,65,-235,-130,-90,-15,FLAT
-25,5,75,80,105,95,95,145,80,25,50,-25,50,60,75,55,65,100,115,25,-15,-15,50,40,FLAT
-140,45,145,190,80,105,95,95,-25,-70,-180,-140,55,-45,-130,-165,25,-10,-105,-85,40,30,-65,-115,FLAT
55,95,10,105,190,80,105,95,-140,-80,5,55,-165,-150,-175,-85,-85,-125,-125,-110,-115,-90,-100,-30,FLAT
45,50,30,80,105,190,80,105,55,65,90,45,-85,-15,95,100,-110,-85,-85,-40,-30,-60,-35,-65,FLAT
20,55,30,85,80,105,190,80,45,20,15,20,100,85,105,65,-40,5,110,120,-65,-65,-70,-20,FLAT
-125,15,165,180,85,80,105,190,20,10,-85,-125,65,30,-70,-105,120,95,20,-60,-20,15,25,-5,FLAT
-10,20,40,60,180,85,80,105,-125,-135,-15,-10,-105,-125,-100,-135,-60,-105,-85,-115,-5,-40,5,-70,FLAT
-45,50,85,135,60,180,85,80,-10,0,-75,-45,-135,-135,-90,-55,-115,-125,-175,-180,-70,-105,-160,-160,FLAT
30,50,45,95,135,60,180,85,-45,-10,30,30,-55,-10,-45,-15,-180,-145,-60,-25,-160,-135,-145,-150,FLAT
0,40,25,65,95,135,60,180,30,-20,10,0,-15,-30,40,30,-25,-30,-35,-15,-150,-165,-50,-25,FLAT
20,20,80,100,65,95,135,60,0,75,40,20,30,55,50,20,-15,45,80,50,-25,45,5,5,FLAT
-110,5,120,125,100,65,95,135,20,-70,-95,-110,20,5,-55,-90,50,-15,-45,-90,5,-25,-15,-60,FLAT
90,90,15,105,125,100,65,95,-110,-15,5,90,-90,-85,-90,-20,-90,-10,-50,0,-60,-30,-40,0,FLAT
-75,10,75,85,105,125,100,65,90,-15,5,-75,-20,-30,10,15,0,-100,-85,-95,0,-25,-45,-75,FLAT
5,30,30,60,85,105,125,100,-75,-40,-15,5,15,-55,-10,-70,-95,-70,-5,20,-75,-140,-100,-90,FLAT
5,40,50,90,60,85,105,125,5,25,-5,5,-70,-15,-20,10,20,-30,-15,-65,-90,-45,-10,25,FLAT
30,50,0,50,70,90,60,85,50,25,45,30,55,30,70,80,60,55,65,85,-15,15,50,90,FLAT
50,55,0,55,50,70,90,60,30,50,45,50,80,75,90,80,85,80,115,130,90,105,110,135,FLAT
60,65,20,85,55,50,70,90,50,80,50,60,80,130,95,110,130,155,140,140,135,160,165,190,FLAT
-25,0,30,30,30,40,55,50,10,0,0,-25,35,5,15,-15,50,40,65,10,30,35,55,25,FLAT
15,25,0,25,30,30,40,55,-25,-15,-10,15,-15,-15,-10,-10,10,-10,5,0,25,25,55,25,FLAT
15,20,15,35,25,30,30,40,15,30,20,15,-10,15,10,30,0,15,10,5,25,20,25,15,FLAT
45,45,10,55,35,25,30,30,15,40,20,45,30,70,40,60,5,55,30,75,15,55,30,50,FLAT
-15,10,15,25,55,35,25,30,45,-10,20,-15,60,30,40,30,75,60,60,45,50,45,50,60,FLAT
15,20,5,25,25,55,35,25,-15,5,5,15,30,-5,25,0,45,35,45,45,60,65,65,60,FLAT
30,30,20,50,25,25,55,35,15,45,20,30,0,50,25,45,45,40,45,30,60,80,65,75,FLAT
-30,40,55,95,50,25,25,55,30,5,-40,-30,45,50,-20,0,30,55,-15,15,75,45,5,0,FLAT
10,20,50,70,95,50,25,25,-30,5,30,10,0,10,-10,-20,15,55,10,10,0,60,15,25,FLAT
-50,40,100,140,70,95,50,25,10,0,-70,-50,-20,5,-40,-40,10,10,-80,-70,25,55,-60,-40,FLAT
20,35,5,40,140,70,95,50,-50,-75,25,20,-40,-75,-45,-30,-70,-70,-15,-20,-40,-65,-55,-50,FLAT
0,35,25,60,40,140,70,95,20,20,0,0,-30,-55,25,20,-20,-55,-45,-30,-50,-50,-15,-20,FLAT
80,90,40,130,60,40,140,70,0,95,25,80,20,115,25,80,-30,40,50,100,-20,40,-20,50,FLAT
-105,125,115,240,130,60,40,140,80,-30,-140,-105,80,65,-115,-25,100,85,-115,-25,50,10,-90,-5,FLAT
115,150,15,165,115,240,130,60,70,85,35,115,-35,85,160,185,45,55,20,80,45,150,45,160,FLAT
5,50,30,80,165,115,240,130,115,20,105,5,185,105,140,120,80,105,265,190,160,75,125,85,FLAT
120,165,10,175,80,165,115,240,5,100,5,120,120,120,110,125,190,205,145,240,85,205,270,310,FLAT
-40,80,45,125,175,80,165,115,120,-5,45,-40,125,95,50,80,240,115,155,85,310,200,190,200,FLAT
110,115,55,170,125,175,80,165,-40,120,75,110,80,115,120,70,85,215,125,190,200,235,230,195,FLAT
-5,40,25,65,170,125,175,80,110,-35,70,-5,70,85,145,105,190,80,190,65,195,180,195,185,FLAT
0,20,30,50,65,170,125,175,-5,5,20,0,105,-30,90,-5,65,90,165,105,185,85,210,65,FLAT
10,45,20,65,115,50,65,170,-80,-65,-15,10,-80,-80,-95,-70,-85,-75,-75,-70,25,-110,-5,-75,FLAT
-60,15,65,80,65,115,50,65,10,-15,-30,-60,-70,-80,-45,-50,-70,-95,-125,-130,-75,-90,-105,-130,FLAT
0,10,45,55,65,80,65,115,30,15,25,0,-30,10,35,30,-20,-5,5,-30,-100,-70,-10,-20,FLAT
190,200,15,215,55,65,80,65,0,160,0,190,30,175,25,190,-30,170,35,220,-20,155,5,160,FLAT
-35,5,55,60,215,55,65,80,190,5,160,-35,190,165,160,155,220,180,185,155,160,175,195,185,FLAT
-15,10,40,50,60,215,55,65,-35,-30,-20,-15,155,-25,140,-50,155,135,140,140,185,150,165,140,FLAT
-25,25,25,50,50,60,215,55,-15,-40,-40,-25,-50,-70,-60,-40,140,-65,100,-75,140,95,100,115,FLAT
-10,15,25,40,50,50,60,215,-25,-10,0,-10,-40,-50,-40,-35,-75,-80,-60,-50,115,-75,100,-85,FLAT
70,70,50,120,60,40,50,50,50,115,55,70,40,145,65,120,15,135,65,110,0,95,25,85,FLAT
75,90,35,125,120,60,40,50,70,60,55,75,120,175,110,145,110,205,120,195,85,195,120,185,FLAT
105,135,65,200,125,120,60,40,75,135,60,105,145,195,115,180,195,310,170,250,185,340,180,300,FLAT
60,65,10,75,200,125,120,60,105,5,130,60,180,140,190,165,250,200,245,240,300,315,300,310,FLAT
-15,10,115,125,75,200,125,120,60,90,40,-15,165,95,170,45,240,230,230,150,310,290,285,225,FLAT
95,105,85,190,125,75,200,125,-15,65,0,95,45,155,40,80,150,160,170,140,225,295,230,245,FLAT
-5,30,30,60,190,125,75,200,95,-60,70,-5,80,5,70,90,140,95,110,75,245,100,240,135,FLAT
-5,20,30,50,60,190,125,75,-5,-5,5,-5,90,-65,75,-10,75,0,75,85,135,90,115,70,FLAT
50,65,10,75,130,50,60,190,-40,-20,35,50,-45,-10,-35,10,-50,-15,-30,5,45,-75,40,0,FLAT
-10,45,15,60,75,130,50,60,50,-5,10,-10,10,-25,45,40,5,-15,-25,0,0,-20,-20,-5,FLAT
-45,0,65,65,60,75,130,50,-10,5,0,-45,40,0,10,-55,0,-20,45,-5,-5,-10,-25,-45,FLAT
-55,5,65,70,65,60,75,130,-45,-55,-60,-55,-55,-50,-60,-100,-5,-55,-50,-110,-45,-75,-15,-60,FLAT
-45,15,65,80,70,65,60,75,-55,-45,-55,-45,-100,-100,-115,-100,-110,-95,-115,-145,-60,-100,-105,-155,FLAT
-20,60,25,85,80,70,65,60,-45,-60,-65,-20,-100,-105,-120,-65,-145,-160,-180,-120,-155,-155,-180,-165,FLAT
-25,35,25,60,85,80,70,65,-20,-25,0,-25,-65,-85,-65,-45,-120,-130,-120,-90,-165,-185,-180,-145,FLAT
50,65,10,75,60,85,80,70,-25,35,20,50,-45,10,20,25,-90,-50,-45,5,-145,-95,-100,-40,FLAT
15,25,20,45,75,60,85,80,50,25,55,15,25,60,75,65,5,35,75,40,-40,-25,10,20,FLAT
-10,15,25,40,45,75,60,85,15,-5,0,-10,65,20,55,5,40,55,75,55,20,30,75,30,FLAT
15,30,0,30,40,45,75,60,-10,-10,0,15,5,-15,0,5,55,10,55,20,30,45,75,70,FLAT
-35,50,40,90,30,40,45,75,15,5,-55,-35,5,-5,-55,-20,20,-10,-55,-30,70,15,0,-15,FLAT
-60,5,60,65,90,30,40,45,-35,-40,-15,-60,-20,-35,-70,-95,-30,-45,-70,-80,-15,-50,-70,-90,FLAT
15,50,0,50,65,90,30,40,-60,-45,-30,15,-95,-85,-45,-45,-80,-80,-100,-80,-90,-90,-100,-65,FLAT
45,45,5,50,40,35,55,30,-15,25,15,45,-5,20,5,30,-50,-10,-5,40,-55,-25,-45,-5,FLAT
10,15,15,30,50,40,35,55,45,20,40,10,30,45,55,55,40,40,45,40,-5,10,35,50,FLAT
-20,0,25,25,30,50,40,35,10,-10,-5,-20,55,10,35,-10,40,35,50,35,50,30,40,20,FLAT
-20,5,30,35,25,30,50,40,-20,-15,-25,-20,-10,-25,-30,-40,35,-5,10,-30,20,20,25,15,FLAT
-5,10,30,40,35,25,30,50,-20,-5,-10,-5,-40,-20,-35,-25,-30,-30,-40,-45,15,-10,0,-35,FLAT
-20,5,25,30,40,35,25,30,-5,-25,-15,-20,-25,-30,-25,-25,-45,-45,-50,-45,-35,-55,-55,-65,FLAT
-40,5,60,65,30,40,35,25,-20,-5,-40,-40,-25,-30,-55,-60,-45,-35,-65,-65,-65,-50,-90,-85,FLAT
30,30,10,40,65,30,40,35,-40,-20,5,30,-60,-25,-35,-10,-65,-50,-50,-30,-85,-55,-60,-35,FLAT
-50,10,55,65,40,65,30,40,30,-5,-30,-50,-10,-25,-25,-20,-30,-30,-65,-60,-35,-55,-80,-80,FLAT
-30,45,60,105,65,40,65,30,-50,-25,-65,-30,-20,-30,-95,-80,-60,-50,-90,-50,-80,-55,-130,-90,FLAT
-5,10,70,80,105,65,40,65,-30,5,30,-5,-80,-20,-35,-35,-50,-25,-65,-85,-90,-45,-60,-55,FLAT
40,40,15,55,90,80,105,65,80,45,80,40,75,65,90,120,45,70,120,115,-5,45,55,85,FLAT
-5,25,75,100,55,90,80,105,40,55,10,-5,120,100,90,35,115,120,100,115,85,125,130,110,FLAT
-85,40,90,130,155,100,55,90,-100,-100,-75,-85,-105,-170,-200,-185,-65,-115,-190,-190,15,-70,-110,-150,FLAT
-5,45,30,75,130,155,100,55,-85,-65,-10,-5,-185,-165,-85,-90,-190,-235,-210,-190,-150,-180,-200,-195,FLAT
-20,20,50,70,75,130,155,100,-5,0,5,-20,-90,-65,-5,-25,-190,-165,-80,-110,-195,-235,-205,-210,FLAT
-70,25,105,130,70,75,130,155,-20,-15,-75,-70,-25,-15,-70,-90,-110,-80,-80,-95,-210,-180,-155,-180,FLAT
25,50,20,70,130,70,75,130,-70,-60,0,25,-90,-75,-75,-45,-95,-75,-70,-65,-180,-140,-80,-70,FLAT
120,125,20,145,70,130,70,75,25,120,45,120,-45,60,45,145,-65,45,-30,75,-70,45,-25,55,FLAT
-30,115,30,145,145,70,130,70,120,-20,-20,-30,145,100,25,90,75,40,25,115,55,25,-50,45,FLAT
60,100,30,130,145,145,70,130,-30,60,75,60,90,40,55,30,115,160,100,150,45,100,100,175,FLAT
-60,20,65,85,130,145,145,70,60,-25,20,-60,30,35,95,0,150,15,75,-30,175,135,120,90,FLAT
-30,30,45,75,85,130,145,145,-60,-50,-40,-30,0,-75,-20,-90,-30,-15,55,-30,90,-35,35,-60,FLAT
10,30,15,45,75,85,130,145,-30,-20,10,10,-90,-70,-30,-20,-30,-95,-10,-80,-60,-35,65,-20,FLAT
-40,15,75,90,45,75,85,130,10,20,-25,-40,-20,0,-15,-30,-80,-50,-55,-60,-20,-75,-35,-120,FLAT
0,0,50,50,90,45,75,85,-40,-25,15,0,-30,-5,-10,-40,-60,-25,0,-30,-120,-75,-40,-60,FLAT
-115,20,120,140,50,90,45,75,0,-45,-135,-115,-40,-70,-120,-115,-30,-50,-145,-155,-60,-70,-135,-145,FLAT
50,105,10,115,140,50,90,45,-115,-60,-35,50,-115,-105,-170,-65,-155,-130,-155,-65,-145,-110,-180,-105,FLAT
45,70,5,75,115,140,50,90,50,40,80,45,-65,-20,45,95,-65,-65,-90,-20,-105,-90,-75,-20,FLAT
-5,60,5,65,75,115,140,50,45,-5,5,-5,95,35,85,40,-20,-25,50,90,-20,-70,-85,-25,FLAT
-110,20,110,130,65,75,115,140,-5,-5,-70,-110,40,-10,-65,-115,90,30,15,-70,-25,-30,-20,-20,FLAT
75,80,30,110,130,65,75,115,-110,-5,15,75,-115,-10,-55,-35,-70,-15,-50,-40,-20,25,30,5,FLAT
95,115,85,200,50,110,130,65,15,155,5,95,90,165,75,110,-20,160,90,185,-25,155,20,75,FLAT
10,70,35,105,200,50,110,130,95,-40,55,10,110,115,60,105,185,125,130,120,75,120,145,195,FLAT
-55,40,70,110,105,200,50,110,10,-20,-25,-55,105,-60,30,-45,120,95,35,50,195,105,105,65,FLAT
-20,15,65,80,110,105,200,50,-55,-25,5,-20,-45,-45,-20,-75,50,-85,35,-65,65,70,40,30,FLAT
45,65,40,105,80,110,105,200,-20,20,-5,45,-75,-5,0,25,-65,-25,-25,-30,30,-65,30,-20,FLAT
75,85,25,110,105,80,110,105,45,60,55,75,25,80,50,120,-30,55,55,100,-20,35,30,45,FLAT
60,110,45,155,110,105,80,110,75,80,35,60,120,140,90,135,100,160,85,180,45,135,90,160,FLAT
5,50,30,80,175,155,110,105,-150,-115,-20,5,-90,-160,-85,-145,-15,-80,-50,-85,30,-20,5,-10,FLAT
-160,95,215,310,80,175,155,110,5,25,-205,-160,-145,-90,-225,-155,-85,-135,-290,-305,-10,-55,-255,-245,FLAT
-45,40,65,105,310,80,175,155,-160,-195,10,-45,-155,-170,-195,-205,-305,-285,-215,-200,-245,-330,-280,-350,FLAT
15,25,45,70,105,310,80,175,-45,-5,30,15,-205,-200,40,-30,-200,-175,-165,-190,-350,-290,-185,-185,FLAT
70,85,5,90,70,105,310,80,15,30,10,70,-30,25,40,85,-190,-170,50,40,-185,-145,-155,-120,FLAT
10,30,40,70,90,70,105,310,70,45,65,10,85,75,75,80,40,70,105,95,-120,-125,115,50,FLAT
-80,30,85,115,70,90,70,105,10,-35,-80,-80,80,10,-15,-70,95,40,-5,0,50,35,25,15,FLAT
5,60,25,85,115,70,90,70,-80,-55,-25,5,-70,-90,-105,-75,0,-45,-40,-65,15,-15,-30,5,FLAT
-25,20,30,50,85,115,70,90,5,-20,15,-25,-75,-75,-10,-20,-65,-110,-90,-100,5,-65,-25,-90,FLAT
75,75,0,75,50,85,115,70,-25,45,20,75,-20,25,35,50,-100,-30,10,55,-90,-65,-70,-25,FLAT
-65,5,85,90,75,50,85,115,75,20,5,-65,50,65,25,10,55,45,40,-15,-25,-10,15,-10,FLAT
-55,5,65,70,90,75,50,85,-65,-75,-55,-55,10,-55,-50,-120,-15,-10,-30,-45,-10,-30,-15,-70,FLAT
-45,20,50,70,70,90,75,50,-55,-60,-60,-45,-120,-135,-115,-100,-45,-115,-110,-165,-70,-70,-90,-90,FLAT
5,55,0,55,70,70,90,75,-45,-45,-30,5,-100,-105,-90,-40,-165,-180,-145,-95,-90,-160,-140,-160,FLAT
-40,15,50,65,35,35,65,135,10,5,-25,-40,25,5,-25,-30,0,-30,-30,-15,-80,-95,-25,-40,FLAT
45,50,0,50,65,35,35,65,-40,-5,10,45,-30,0,-15,5,-15,0,-15,15,-40,-35,-20,30,FLAT
-20,10,25,35,50,65,35,35,45,5,20,-20,5,0,30,25,15,5,5,-15,30,5,5,-5,FLAT
20,30,15,45,35,50,65,35,-20,10,0,20,25,15,20,0,-15,10,30,45,-5,15,5,5,FLAT
-15,20,15,35,45,35,50,65,20,-15,-5,-15,0,-5,-5,5,45,0,15,-15,5,-5,25,30,FLAT
-10,10,25,35,35,45,35,50,-15,0,0,-10,5,-15,-5,-25,-15,-5,-5,-5,30,0,15,-25,FLAT
15,15,20,35,35,35,45,35,-10,10,10,15,-25,10,10,5,-5,-5,5,-10,-25,5,5,10,FLAT
10,25,15,40,35,35,35,45,15,5,0,10,5,15,10,25,-10,15,10,15,10,0,5,0,FLAT
10,65,0,65,40,35,35,35,10,-5,-30,10,25,0,-30,20,15,10,-20,35,0,10,-20,25,FLAT
55,60,15,75,100,65,40,35,60,70,95,55,70,130,120,115,80,125,90,125,95,130,90,135,FLAT
25,30,50,80,75,100,65,40,55,60,55,25,115,130,150,80,125,190,175,140,135,185,145,150,FLAT
55,80,15,95,80,75,100,65,25,20,5,55,80,80,60,80,140,150,155,135,150,210,180,195,FLAT
90,115,35,150,95,80,75,100,55,110,55,90,80,130,60,145,135,190,115,170,195,260,210,225,FLAT
50,65,40,105,150,95,80,75,90,55,100,50,145,165,155,140,170,185,160,195,225,245,215,220,FLAT
45,80,85,165,105,150,95,80,50,90,30,45,140,145,130,95,195,255,185,185,220,275,190,240,FLAT
55,55,10,65,165,105,150,95,45,-20,80,55,95,70,110,100,185,125,210,150,240,235,265,240,FLAT
-60,30,65,95,65,165,105,150,55,-5,-35,-60,100,-25,45,-5,150,65,75,40,240,120,175,90,FLAT
15,25,50,75,95,65,165,105,-60,0,20,15,-5,-5,-15,-45,40,-25,65,10,90,65,95,55,FLAT
25,60,20,80,75,95,65,165,15,-5,-10,25,-45,-5,10,40,10,-10,-25,-20,55,-30,55,35,FLAT
60,75,70,145,80,75,95,65,25,110,45,60,40,105,35,85,-20,105,55,100,35,100,20,40,FLAT
70,75,40,115,145,80,75,95,60,40,70,70,85,150,115,130,100,145,105,155,40,145,125,170,FLAT
-25,5,40,45,115,145,80,75,70,-25,45,-25,130,15,115,45,155,125,160,105,170,120,150,130,FLAT
25,55,10,65,45,115,145,80,-25,-5,-25,25,45,-30,20,0,105,10,90,70,130,120,135,130,FLAT
10,50,35,85,65,45,115,145,25,35,15,10,0,30,-10,35,70,5,35,10,130,45,105,80,FLAT
55,70,40,110,85,65,45,115,10,60,35,55,35,95,50,65,10,90,25,90,80,65,70,65,FLAT
80,85,70,155,110,85,65,45,55,110,65,80,65,170,100,135,90,205,115,145,65,200,90,170,FLAT
15,50,25,75,155,110,85,65,80,-30,50,15,135,80,115,95,145,140,150,150,170,175,165,160,FLAT
45,70,15,85,75,155,110,85,15,35,25,45,95,5,75,60,150,115,140,140,160,175,175,195,FLAT
-50,50,70,120,85,75,155,110,45,5,-30,-50,60,40,-5,-5,140,10,45,10,195,120,110,90,FLAT
-30,10,45,55,120,85,75,155,-50,-55,10,-30,-5,-50,-20,-80,10,-15,5,-35,90,-45,55,-20,FLAT
50,55,30,85,55,120,85,75,-30,35,5,50,-80,-20,15,20,-35,-15,-15,-30,-20,20,10,15,FLAT
90,105,15,120,85,55,120,85,50,75,40,90,20,110,45,140,-30,55,55,110,15,60,25,60,FLAT
0,10,65,75,110,120,85,55,-105,-40,-5,0,-15,-55,-10,-105,35,20,30,-15,5,55,35,35,FLAT
0,40,35,75,75,110,120,85,0,-30,-30,0,-105,-70,-35,0,-15,-85,-40,-105,35,-10,0,-15,FLAT
-10,35,50,85,75,75,110,120,0,5,-5,-10,0,-25,-35,-10,-105,-65,-40,-10,-15,-80,-45,-115,FLAT
55,110,0,110,70,85,75,75,60,50,10,55,50,65,40,115,50,70,35,105,50,40,5,105,FLAT
80,155,15,170,110,70,85,75,55,95,35,80,115,145,45,135,105,160,75,195,105,165,70,185,FLAT
10,55,115,170,170,110,70,85,80,110,110,10,135,205,145,90,195,255,155,145,185,270,185,205,FLAT
75,75,120,195,170,170,110,70,10,80,55,75,90,190,165,85,145,285,200,165,205,335,210,220,FLAT
160,160,80,240,195,170,170,110,75,120,75,160,85,200,130,235,165,310,240,245,220,405,275,325,FLAT
5,30,75,105,235,240,195,170,-225,-150,-20,5,-65,-225,-90,-220,10,-105,-15,-60,20,-25,40,15,FLAT
-70,10,115,125,105,235,240,195,5,-30,-50,-70,-220,-180,-70,-65,-60,-255,-140,-290,15,-135,-65,-130,FLAT
35,50,25,75,125,105,235,240,-70,-55,-5,35,-65,-85,-55,-35,-290,-235,-75,-30,-130,-310,-145,-255,FLAT
65,65,25,90,75,125,105,235,35,65,50,65,-35,10,45,100,-30,-20,-5,30,-255,-170,-25,35,FLAT
5,15,35,50,90,75,125,105,65,15,55,5,100,80,105,70,30,25,100,105,35,-5,50,35,FLAT
-10,40,25,65,50,90,75,125,5,-20,-35,-10,70,-5,20,-5,105,60,70,60,35,5,65,95,FLAT
-10,5,55,60,65,50,90,75,-10,20,25,-10,-5,0,-10,-20,60,15,45,-15,95,80,95,50,FLAT
-20,25,25,50,60,65,50,90,-10,-50,-40,-20,-20,-30,-15,-30,-15,-50,-50,-40,50,-35,5,-35,FLAT
20,25,10,35,50,60,65,50,-20,5,20,20,-30,-45,-20,0,-40,-25,5,-10,-35,-45,-30,-20,FLAT
-80,5,85,90,35,50,60,65,20,-5,-60,-80,0,0,-40,-60,-10,-50,-80,-80,-20,-30,-55,-90,FLAT
20,20,25,45,90,35,50,60,-80,-40,5,20,-60,-45,-55,-60,-80,-40,-35,-40,-90,-90,-75,-60,FLAT
-25,5,35,40,35,25,20,25,25,0,-5,-25,5,10,-5,0,5,10,-10,-20,30,15,0,-20,FLAT
0,5,20,25,40,35,25,20,-25,-15,0,0,0,-15,-5,-25,-20,-5,-5,0,-20,-5,-10,-20,FLAT
30,40,5,45,25,40,35,25,0,15,-5,30,-25,0,-5,30,0,0,-10,5,-20,10,-10,30,FLAT
45,85,0,85,45,25,40,35,30,40,0,45,30,55,-5,75,5,40,-5,75,30,40,-10,50,FLAT
-20,5,45,50,85,45,25,40,45,25,60,-20,75,65,60,25,75,80,55,55,50,65,55,55,FLAT
-30,10,40,50,50,85,45,25,-20,-35,-35,-30,25,-10,25,-50,55,30,25,-5,55,45,20,25,FLAT
10,20,10,30,50,50,85,45,-30,-20,0,10,-50,-55,-35,-20,-5,-30,25,-40,25,10,25,5,FLAT
-90,0,95,95,30,50,50,85,10,-5,-70,-90,-20,-25,-70,-80,-40,-60,-105,-110,5,-35,-45,-130,FLAT
20,25,35,60,95,30,50,50,-90,-40,-5,20,-80,-45,-75,-70,-110,-65,-75,-60,-130,-100,-110,-90,FLAT
95,100,15,115,70,60,95,30,45,85,40,95,65,120,65,140,-25,80,60,160,-15,75,-10,70,FLAT
65,95,25,120,115,70,60,95,95,75,70,65,140,160,110,160,160,195,135,205,70,155,130,225,FLAT
15,65,5,70,120,115,70,60,65,-5,45,15,160,70,115,80,205,155,155,175,225,190,180,220,FLAT
85,105,5,110,70,120,115,70,15,85,45,85,80,80,90,100,175,155,160,165,220,240,200,260,FLAT
-90,15,130,145,110,70,120,115,85,35,0,-90,100,120,45,-5,165,115,90,10,260,190,160,75,FLAT
85,135,15,150,145,110,70,120,-90,-30,-35,85,-5,5,-35,-5,10,90,10,80,75,85,55,95,FLAT
95,120,130,250,150,145,110,70,85,210,110,95,-5,180,75,180,80,215,75,90,95,300,120,175,FLAT
-20,70,30,100,250,150,145,110,95,-120,30,-20,180,90,140,75,90,60,105,160,175,95,105,70,FLAT
-30,10,50,60,100,250,150,145,-20,-10,30,-30,75,-130,60,-50,160,80,170,45,70,50,135,130,FLAT
-35,30,65,95,60,100,250,150,-30,-20,-55,-35,-50,-30,-25,-65,45,-150,5,-85,130,60,115,10,FLAT
10,30,30,60,95,60,100,250,-35,-25,10,10,-65,-45,-45,-25,-85,-55,-15,-55,10,-175,15,-75,FLAT
100,115,35,150,60,95,60,100,10,105,15,100,-25,80,25,110,-55,60,-30,75,-75,50,0,45,FLAT
15,70,50,120,150,60,95,60,100,30,60,15,110,135,75,115,75,110,85,125,45,90,30,90,FLAT
-5,40,50,90,120,150,60,95,15,-5,25,-5,115,25,85,10,125,130,100,110,90,105,110,120,FLAT
30,30,45,75,90,120,150,60,-5,25,40,30,10,20,65,25,110,50,125,40,120,155,140,140,FLAT
-45,30,70,100,75,90,120,150,30,-20,-45,-45,25,5,-5,-15,40,0,20,-20,140,30,80,-5,FLAT
15,15,70,85,100,75,90,120,-45,15,30,15,-15,-5,-15,-30,-20,20,25,0,-5,15,50,-5,FLAT
-75,25,80,105,85,100,75,90,15,-65,-85,-75,-30,-50,-55,-60,0,-70,-100,-105,-5,-45,-60,-75,FLAT
0,45,10,55,105,85,100,75,-75,-70,-20,0,-60,-135,-105,-75,-105,-120,-75,-60,-75,-140,-120,-105,FLAT
-125,5,125,130,55,105,85,100,0,-10,-85,-125,-75,-80,-105,-125,-60,-145,-190,-200,-105,-130,-160,-185,FLAT
-20,45,35,80,130,55,105,85,-125,-110,-60,-20,-125,-120,-145,-145,-200,-190,-165,-145,-185,-255,-250,-220,FLAT
20,50,10,60,80,130,55,105,-20,-5,15,20,-145,-115,-45,0,-145,-125,-130,-125,-220,-195,-150,-125,FLAT
-110,15,120,135,60,80,130,55,20,0,-75,-110,0,-5,-60,-90,-125,-115,-120,-110,-125,-125,-205,-235,FLAT
65,90,0,90,135,60,80,130,-110,-55,-10,65,-90,-55,-85,-45,-110,-60,-70,-25,-235,-170,-130,-45,FLAT
-15,30,70,100,90,135,60,80,65,55,45,-15,-45,0,35,50,-25,0,-40,-60,-45,-5,-25,-40,FLAT
-5,65,20,85,100,90,135,60,-15,-55,-40,-5,50,0,5,-20,-60,-55,-5,45,-40,-55,-80,-65,FLAT
-110,40,115,155,85,100,90,135,-5,-15,-85,-110,-20,-70,-125,-115,45,-15,-80,-130,-65,-70,-90,-65,FLAT
15,30,35,65,85,90,155,85,70,35,55,15,90,75,100,85,-20,25,115,105,-25,10,30,-5,FLAT
25,30,70,100,65,85,90,155,15,60,25,25,85,95,80,40,105,135,125,110,-5,85,140,130,FLAT
385,385,0,385,100,65,85,90,25,315,30,385,40,375,55,410,110,410,110,425,130,450,155,495,FLAT
135,155,15,170,385,100,65,85,385,150,365,135,410,465,395,520,425,525,420,545,495,560,475,560,FLAT
10,40,70,110,170,385,100,65,135,65,125,10,520,215,490,145,545,530,520,530,560,590,545,555,FLAT
125,135,40,175,110,170,385,100,10,95,30,125,145,160,155,135,530,310,520,270,555,625,550,655,FLAT
-5,35,10,45,135,105,175,110,-110,-125,-35,-5,-135,-140,-80,-115,-10,-170,-40,-140,0,-75,-10,-15,FLAT
-45,20,70,90,45,135,105,175,-5,15,-30,-45,-115,-110,-65,-50,-140,-125,-110,-160,-15,-155,-70,-185,FLAT
-10,60,40,100,90,45,135,105,-45,-40,-50,-10,-50,-25,-80,-55,-160,-150,-115,-60,-185,-165,-160,-170,FLAT
-5,35,20,55,100,90,45,135,-10,-25,20,-5,-55,-65,-30,-15,-60,-50,-60,-60,-170,-175,-95,-65,FLAT
-15,30,35,65,55,100,90,45,-5,0,-10,-15,-15,-25,10,-20,-60,-65,-40,-30,-65,-50,-70,-75,FLAT
-15,30,30,60,65,55,100,90,-15,-20,-15,-15,-20,-20,-25,-30,-30,-45,-5,-35,-75,-85,-55,-45,FLAT
-5,25,25,50,60,65,55,100,-15,-10,0,-5,-30,-30,-15,-20,-35,-30,-25,-35,-45,-55,-5,-40,FLAT
15,15,35,50,50,60,65,55,-5,25,25,15,-20,15,25,10,-35,-5,10,-5,-40,-5,0,-20,FLAT
10,10,15,25,50,50,60,65,15,-10,15,10,10,15,40,25,-5,5,40,20,-20,-15,25,5,FLAT
0,25,5,30,25,50,50,60,10,-10,-15,0,25,-20,0,10,20,5,25,25,5,-5,25,20,FLAT
0,43,0,43,32,18,40,35,-17,-17,-28,0,-26,-30,-55,-17,-11,-27,-30,-26,-36,-46,-54,-11,FLAT
-55,6,56,62,43,32,18,40,0,1,-18,-55,-17,-16,-46,-55,-26,-29,-73,-72,-11,-26,-48,-81,FLAT
14,19,16,35,62,43,32,18,-55,-26,1,14,-55,-25,-17,-41,-72,-42,-45,-41,-81,-55,-72,-58,FLAT
-10,6,15,21,35,62,43,32,14,-11,3,-10,-41,-37,4,4,-41,-36,-14,-51,-58,-53,-42,-51,FLAT
1,11,15,26,21,35,62,43,-10,1,-4,1,4,-10,-1,-9,-51,-36,0,5,-51,-35,-18,-50,FLAT
-26,4,29,33,26,21,35,62,1,-12,-19,-26,-9,-11,-23,-25,5,-22,-20,-35,-50,-48,-19,-21,FLAT
11,15,17,32,33,26,21,35,-26,-1,0,11,-25,-13,-19,-15,-35,-12,-23,-14,-21,-23,-20,-24,FLAT
13,33,9,42,32,33,26,21,11,5,-5,13,-15,4,-5,24,-14,-8,-24,-2,-24,-7,-28,-1,FLAT
32,38,12,50,42,32,33,26,13,35,27,32,24,40,22,45,-2,39,22,56,-1,27,3,30,FLAT
-38,41,57,98,50,42,32,33,32,7,-41,-38,45,42,-14,-6,56,47,-19,7,30,46,-19,18,FLAT
-21,12,57,69,98,50,42,32,-38,-21,8,-21,-6,-14,-33,-59,7,21,-6,-27,18,26,-11,-14,FLAT
-40,13,64,77,69,98,50,42,-21,-33,-41,-40,-59,-54,-33,-61,-27,-47,-74,-99,-14,-12,-47,-67,FLAT
5,17,50,67,77,69,98,50,-40,-9,1,5,-61,-42,-40,-35,-99,-63,-32,-56,-67,-56,-73,-94,FLAT
132,140,6,146,67,77,69,98,5,88,9,132,-35,79,10,137,-56,46,-31,97,-94,25,-23,76,FLAT
-2,21,41,62,146,67,77,69,132,33,117,-2,137,121,126,130,97,112,127,135,76,79,86,95,FLAT
-24,8,85,93,62,146,67,77,-2,20,-11,-24,130,53,106,-26,135,141,115,106,95,132,116,111,FLAT
-29,34,42,76,124,93,62,146,-87,-100,-52,-29,-111,-159,-142,-116,-113,-139,-153,-140,19,-106,-36,-142,FLAT
28,36,3,39,76,124,93,62,-29,-11,26,28,-116,-111,-26,-1,-140,-170,-116,-88,-142,-150,-127,-112,FLAT
-71,0,118,118,39,76,124,93,28,44,-35,-71,-1,33,-9,-43,-88,-67,-61,-72,-112,-126,-151,-159,FLAT
80,102,6,108,118,39,76,124,-71,-32,-22,80,-43,12,-57,9,-72,1,-31,37,-159,-99,-83,8,FLAT
73,80,21,101,108,118,39,76,80,88,95,73,9,56,73,153,37,100,38,82,8,89,64,110,FLAT
-140,0,145,145,101,108,118,39,73,-16,-60,-140,153,72,35,-67,82,40,13,13,110,84,-22,-58,FLAT
46,49,18,67,145,101,108,118,-140,-81,-3,46,-67,-97,-63,-94,13,-9,32,-21,-58,-41,10,59,FLAT
31,31,29,60,67,145,101,108,46,42,49,31,-94,-39,46,77,-21,-55,-14,-63,59,33,81,10,FLAT
-27,31,33,64,60,67,145,101,31,-23,-27,-27,77,19,22,4,-63,-62,19,50,10,-78,-41,-90,FLAT
3,8,39,47,64,60,67,145,-27,9,26,3,4,-14,-1,-24,50,28,48,7,-90,-53,45,53,FLAT
-64,4,64,68,47,64,60,67,3,-39,-60,-64,-24,-30,-34,-61,7,-53,-61,-88,53,-11,-12,-57,FLAT
25,46,26,72,68,47,64,60,-64,-13,-17,25,-61,-52,-77,-39,-88,-43,-51,-36,-57,-66,-78,-63,FLAT
-88,20,99,119,72,68,47,64,25,-15,-62,-88,-39,-28,-79,-63,-36,-67,-139,-127,-63,-58,-113,-124,FLAT
26,45,2,47,119,72,68,47,-88,-71,1,26,-63,-86,-61,-62,-127,-99,-78,-37,-124,-138,-138,-101,FLAT
9,40,1,41,47,119,72,68,26,8,14,9,-62,-63,15,35,-37,-78,-47,-53,-101,-91,-64,-28,FLAT
8,37,26,63,41,47,119,72,9,33,11,8,35,41,25,17,-53,-30,26,43,-28,-45,-36,-45,FLAT
4,40,15,55,63,41,47,119,8,-7,1,4,17,26,12,12,43,34,26,21,-45,-37,27,47,FLAT
103,114,56,170,55,63,41,47,4,144,29,103,12,137,30,107,21,170,41,115,47,178,55,124,FLAT
30,37,81,118,170,55,63,41,103,55,107,30,107,199,136,133,115,192,137,137,124,225,148,145,FLAT
29,48,21,69,118,170,55,63,30,-31,18,29,133,24,125,59,137,168,154,162,145,161,155,166,FLAT
-35,22,58,80,69,118,170,55,29,2,-9,-35,59,-29,9,-6,162,26,116,24,166,170,145,127,FLAT
4,35,28,63,146,80,69,118,-125,-93,-10,4,-160,-151,-134,-121,-131,-149,-143,-156,-101,-180,-125,-127,FLAT
-23,1,94,95,63,146,80,69,4,43,11,-23,-121,-50,1,-19,-156,-108,-123,-144,-127,-106,-132,-179,FLAT
-5,120,275,395,95,63,146,80,-23,176,-124,-5,-19,219,-113,-28,-144,126,-123,-24,-179,68,-247,-149,FLAT
-75,0,104,104,395,95,63,146,-5,-246,45,-75,-28,-70,-79,-80,-24,-27,-68,-103,-149,-120,-78,-99,FLAT
-176,30,184,214,104,395,95,63,-75,-96,-206,-176,-80,-342,-161,-251,-103,-166,-285,-256,-99,-123,-274,-279,FLAT
-43,73,79,152,214,104,395,95,-176,-148,-86,-43,-251,-244,-292,-219,-256,-490,-247,-294,-279,-314,-371,-299,FLAT
50,96,33,129,152,214,104,395,-43,4,27,50,-219,-144,-59,7,-294,-240,-265,-169,-299,-486,-220,-244,FLAT
47,51,10,61,129,152,214,104,50,24,92,47,7,28,119,97,-169,-120,33,54,-244,-216,-173,-122,FLAT
-5,24,39,63,61,129,152,214,47,24,22,-5,97,48,114,42,54,52,141,92,-122,-96,55,49,FLAT
-19,38,62,100,63,61,129,152,-5,4,-33,-19,42,28,-11,-24,92,52,81,23,49,56,108,73,FLAT
-44,10,50,60,67,100,63,61,-32,-50,-43,-44,-51,-88,-48,-76,-56,-84,-81,-95,-9,-60,-59,-100,FLAT
-55,17,64,81,60,67,100,63,-44,-41,-62,-55,-76,-91,-105,-99,-95,-129,-110,-131,-100,-125,-143,-150,FLAT
-76,5,77,82,81,60,67,100,-55,-63,-64,-76,-99,-104,-126,-131,-131,-154,-169,-175,-150,-192,-174,-207,FLAT
0,39,38,77,82,81,60,67,-76,-39,-34,0,-131,-102,-98,-76,-175,-143,-160,-131,-207,-193,-203,-175,FLAT
10,26,8,34,77,82,81,60,0,-20,23,10,-76,-59,-11,10,-131,-122,-75,-66,-175,-163,-137,-121,FLAT
-38,1,52,53,34,77,82,81,10,6,-13,-38,10,-14,10,-28,-66,-53,-24,-28,-121,-116,-88,-104,FLAT
69,97,0,97,53,34,77,82,-38,17,-27,69,-28,23,-40,31,-28,3,-17,41,-104,-36,-51,41,FLAT
9,19,2,21,26,42,36,26,7,-2,3,9,33,9,30,16,45,26,41,42,42,44,49,54,FLAT
-22,2,43,45,21,26,42,36,9,19,-5,-22,16,17,-2,-13,42,28,25,-6,54,45,36,20,FLAT
21,21,0,21,45,21,26,42,-22,-22,2,21,-13,-3,-3,-1,-6,-5,0,8,20,6,27,15,FLAT
14,20,0,20,21,45,21,26,21,14,15,14,-1,-8,17,35,8,11,12,13,15,9,15,22,FLAT
-6,3,32,35,20,21,45,21,14,26,11,-6,35,40,26,8,13,18,28,29,22,37,23,7,FLAT
-3,28,9,37,35,20,21,45,-6,-26,-28,-3,8,0,-17,-9,29,14,-2,5,7,-8,0,26,FLAT
1,24,9,33,37,35,20,21,-3,1,5,1,-9,-25,-23,-2,5,1,-12,-8,26,15,3,6,FLAT
-5,19,11,30,33,37,35,20,1,-3,0,-5,-2,-2,5,-4,-8,-28,-23,-7,6,-2,-12,-13,FLAT
24,60,2,62,65,47,30,33,38,12,15,24,64,50,35,62,59,79,47,88,60,76,47,83,FLAT
17,24,40,64,62,65,47,30,24,55,53,17,62,67,68,41,88,105,88,79,83,134,100,105,FLAT
-4,30,32,62,64,62,65,47,17,-12,-10,-4,41,43,43,13,79,55,58,37,105,93,78,75,FLAT
138,149,7,156,62,64,62,65,-4,113,19,138,13,101,9,134,37,156,62,151,75,168,77,175,FLAT
-25,37,39,76,156,62,64,62,138,7,87,-25,134,120,106,113,151,108,96,109,175,163,149,126,FLAT
-36,5,59,64,102,76,156,62,-31,-32,6,-36,-56,-47,-35,-67,82,-40,52,-92,78,73,71,46,FLAT
-34,12,68,80,64,102,76,156,-36,-25,-41,-34,-67,-57,-35,-70,-92,-72,-76,-101,46,-65,11,-126,FLAT
-65,10,95,105,80,64,102,76,-34,-38,-63,-65,-70,-63,-104,-99,-101,-95,-98,-135,-126,-110,-139,-166,FLAT
56,91,12,103,105,80,64,102,-65,-27,-25,56,-99,-65,-88,-9,-135,-90,-129,-43,-166,-122,-123,-79,FLAT
-30,34,43,77,103,105,80,64,56,1,27,-30,-9,-26,2,26,-43,-64,-61,-39,-79,-89,-102,-73,FLAT
-10,16,54,70,77,103,105,80,-30,1,8,-10,26,2,35,-40,-39,-25,10,16,-73,-63,-53,-49,FLAT
-26,36,31,67,70,77,103,105,-10,-49,-46,-26,-40,-48,-38,-36,16,-47,-11,-66,-49,-74,-36,-10,FLAT
51,58,4,62,67,70,77,103,-26,24,29,51,-36,-25,-17,25,-66,-24,-9,15,-10,-23,18,-15,FLAT
78,86,16,102,62,67,70,77,51,90,50,78,25,114,79,129,15,65,33,103,-15,66,41,93,FLAT
-53,21,54,75,102,62,67,70,78,-15,12,-53,129,75,62,25,103,99,91,76,93,50,45,50,FLAT
28,44,10,54,75,102,62,67,-53,-16,5,28,25,-31,17,-25,76,59,67,53,50,83,96,104,FLAT
-26,16,35,51,54,75,102,62,28,-1,2,-26,-25,-17,7,2,53,-32,19,-51,104,58,69,27,FLAT
-38,22,38,60,51,54,75,102,-26,-35,-44,-38,2,-36,-42,-64,-51,-52,-37,-36,27,-67,-25,-89,FLAT
114,117,6,123,60,51,54,75,-38,82,19,114,-64,47,-25,76,-36,46,-23,50,-89,30,-18,78,FLAT
-7,17,8,25,123,60,51,54,114,-5,93,-7,76,77,112,107,50,42,68,69,78,41,70,43,FLAT
3,21,42,63,25,123,60,51,-7,37,-1,3,107,32,92,-4,69,114,111,110,43,79,67,72,FLAT
44,44,16,60,63,25,123,60,3,18,21,44,-4,55,20,47,110,50,113,40,72,132,132,154,FLAT
3,23,18,41,60,63,25,123,44,5,24,3,47,23,45,47,40,60,44,50,154,55,137,43,FLAT
-56,64,157,221,78,41,60,63,-60,39,-104,-56,-57,23,-157,-116,-13,28,-133,-113,-10,46,-112,-69,FLAT
-117,30,142,172,221,78,41,60,-56,-132,-83,-117,-116,-93,-187,-173,-113,-109,-240,-233,-69,-104,-216,-230,FLAT
-46,18,60,78,172,221,78,41,-117,-128,-34,-46,-173,-260,-117,-163,-233,-221,-221,-219,-230,-237,-274,-279,FLAT
35,51,43,94,78,172,221,78,-46,18,2,35,-163,-110,-32,-11,-219,-242,-115,-128,-279,-203,-219,-184,FLAT
40,76,16,92,87,94,78,172,16,-15,-20,40,51,29,31,56,5,47,33,91,-112,-81,-1,45,FLAT
181,224,6,230,92,87,94,78,40,171,33,181,56,156,13,221,91,200,64,237,45,218,66,272,FLAT
-13,43,47,90,230,92,87,94,181,28,168,-13,221,199,201,168,237,184,181,208,272,228,232,224,FLAT
4,31,46,77,90,230,92,87,-13,3,16,4,168,31,184,-9,208,202,217,172,224,187,197,212,FLAT
92,108,8,116,77,90,230,92,4,54,15,92,-9,57,31,96,172,85,199,83,212,256,232,264,FLAT
-4,16,57,73,116,77,90,230,92,45,88,-4,96,99,103,88,83,102,119,92,264,130,287,79,FLAT
-12,20,17,37,73,116,77,90,-4,-52,-16,-12,88,-7,72,-16,92,47,87,76,79,50,103,80,FLAT
40,43,13,56,37,73,116,77,-12,36,17,40,-16,-16,1,28,76,29,89,24,80,83,104,116,FLAT
5,52,16,68,56,37,73,116,40,8,-4,5,28,44,13,45,24,-8,-3,33,116,37,85,29,FLAT
102,103,0,103,68,56,37,73,5,86,51,102,45,94,47,107,33,130,64,147,29,78,48,135,FLAT
-22,23,27,50,103,68,56,37,102,5,58,-22,107,91,109,80,147,99,105,85,135,135,122,125,FLAT
5,11,31,42,50,103,68,56,-22,9,17,5,80,14,75,-17,85,100,126,85,125,108,122,90,FLAT
-2,9,25,34,42,50,103,68,5,-8,0,-2,-17,1,17,3,85,6,75,-19,90,92,126,83,FLAT
-30,4,40,44,45,34,42,50,-18,-25,-24,-30,-20,-33,-43,-48,-15,-41,-43,-50,-37,-32,-26,-45,FLAT
48,48,2,50,44,45,34,42,-30,10,4,48,-48,-15,-20,18,-50,-23,-39,0,-45,-31,-39,-2,FLAT
-6,15,10,25,50,44,45,34,48,2,27,-6,18,12,31,42,0,-13,7,12,-2,-21,-12,-6,FLAT
0,10,2,12,15,10,18,28,-3,-4,-1,0,3,-1,-3,-3,-7,-12,-6,3,-15,-16,0,-7,FLAT
-2,1,13,14,12,15,10,18,0,9,7,-2,-3,5,6,-2,3,8,4,-5,-7,-3,1,1,FLAT
-18,1,19,20,14,12,15,10,-2,-12,-18,-18,-2,-3,-11,-20,-5,-7,-12,-20,1,-4,-14,-23,FLAT
-9,2,18,20,20,14,12,15,-18,-10,-10,-9,-20,-22,-28,-27,-20,-13,-21,-29,-23,-17,-22,-29,FLAT
-21,0,27,27,20,20,14,12,-9,-12,-19,-21,-27,-22,-29,-30,-29,-34,-47,-48,-29,-25,-40,-50,FLAT
4,8,8,16,27,20,20,14,-21,-15,-4,4,-30,-27,-23,-17,-48,-37,-33,-26,-50,-49,-51,-44,FLAT
17,18,1,19,16,27,20,20,4,10,7,17,-17,-5,3,21,-26,-17,-16,0,-44,-27,-26,-9,FLAT
0,14,9,23,19,16,27,20,17,8,4,0,21,18,11,17,0,3,7,21,-9,-9,-12,0,FLAT
3,11,18,29,23,19,16,27,0,12,6,3,17,20,10,3,21,30,17,20,0,15,13,24,FLAT
-51,6,51,57,29,23,19,16,3,-18,-46,-51,3,-6,-40,-48,20,2,-36,-48,24,12,-29,-31,FLAT
68,69,4,73,57,29,23,19,-51,21,5,68,-48,3,-41,17,-48,15,-35,20,-31,23,-31,20,FLAT
-20,9,24,33,73,57,29,23,68,0,40,-20,17,21,45,48,20,3,-1,-3,20,15,5,0,FLAT
14,20,0,20,33,73,57,29,-20,-10,3,14,48,-10,43,-6,-3,11,48,62,0,-7,2,11,FLAT
3,29,10,39,20,33,73,57,14,13,-6,3,-6,3,-3,17,62,3,37,-3,11,24,42,65,FLAT
0,11,10,21,39,20,33,73,3,0,18,0,17,13,12,3,-3,3,15,17,65,3,55,-3,FLAT
-26,1,35,36,21,39,20,33,0,-1,-16,-26,3,-1,2,-26,17,12,-4,-23,-3,2,-1,-9,FLAT
-5,13,11,24,36,21,39,20,-26,-29,-17,-5,-26,-30,-33,-31,-23,-30,-15,-31,-9,-17,-21,-28,FLAT
-9,14,9,23,24,36,21,39,-5,-11,-10,-9,-31,-40,-27,-14,-31,-41,-43,-40,-28,-41,-25,-40,FLAT
18,22,3,25,23,24,36,21,-9,12,10,18,-14,1,0,9,-40,-28,-17,4,-40,-29,-33,-22,FLAT
-10,5,24,29,25,23,24,36,18,11,7,-10,9,23,17,8,4,12,7,-1,-22,-17,-10,-6,FLAT
1,4,9,13,29,25,23,24,-10,-14,2,1,8,-3,9,-9,-1,9,19,9,-6,-2,9,0,FLAT
-9,32,9,41,13,29,25,23,1,-9,-37,-9,-9,-23,-35,-8,9,-12,-28,-18,0,0,-18,0,FLAT
-4,8,18,26,41,13,29,25,-9,5,20,-4,-8,-4,-17,-13,-18,-18,-15,-12,0,-7,-8,-22,FLAT
9,26,4,30,26,41,13,29,-4,-5,-9,9,-13,0,11,5,-12,-9,-26,-4,-22,-23,-24,-3,FLAT
-15,0,17,17,30,26,41,13,9,-2,11,-15,5,-7,2,-6,-4,-2,22,-10,-3,-11,-15,-19,FLAT
5,36,5,41,17,30,26,41,-15,-7,-31,5,-6,-9,-20,-10,-10,-14,-29,-1,-19,-9,-9,-5,FLAT
16,22,5,27,41,17,30,26,5,16,30,16,-10,9,-1,21,-1,7,10,6,-5,2,1,15,FLAT
20,26,15,41,27,41,17,30,16,30,16,20,21,46,46,36,6,39,15,41,15,37,26,26,FLAT
40,46,1,47,41,27,41,17,20,26,20,40,36,56,36,60,41,72,66,76,26,65,35,81,FLAT
-17,21,18,39,47,41,27,41,40,0,8,-17,60,26,28,23,76,56,44,43,81,72,74,59,FLAT
28,34,0,34,43,23,39,47,-40,-12,-3,28,-52,-24,-35,-12,-69,-42,-37,-24,-29,-42,-29,-41,FLAT
-25,9,26,35,34,43,23,39,28,1,0,-25,-12,-11,-3,3,-24,-23,-35,-37,-41,-41,-37,-49,FLAT
7,42,19,61,35,34,43,23,-25,0,-26,7,3,1,-26,-18,-37,-11,-29,10,-49,-23,-61,-30,FLAT
-209,185,217,402,61,35,34,43,7,-11,-352,-209,-18,-11,-378,-202,10,-10,-378,-227,-30,-22,-381,-199,FLAT
88,111,70,181,402,61,35,34,-209,-59,162,88,-202,-70,-190,-121,-227,-70,-216,-114,-199,-69,-216,-139,FLAT
-25,0,69,69,181,402,61,35,88,-26,86,-25,-121,-85,248,63,-114,-96,-104,-146,-139,-96,-130,-139,FLAT
13,59,6,65,69,181,402,61,-25,-50,-46,13,63,-76,40,-12,-146,-135,202,76,-139,-146,-150,-133,FLAT
-69,9,90,99,65,69,181,402,13,15,-19,-69,-12,-35,-65,-56,76,-61,21,-81,-133,-120,183,7,FLAT
31,53,6,59,99,65,69,181,-69,-53,-13,31,-56,-38,-32,-38,-81,-88,-78,-25,7,-114,8,-50,FLAT
60,62,10,72,85,59,99,65,85,70,83,60,116,149,136,145,47,96,123,176,60,111,104,107,FLAT
13,53,3,56,72,85,59,99,60,6,22,13,145,76,105,73,176,155,158,158,107,102,145,189,FLAT
3,31,3,34,56,72,85,59,13,3,25,3,73,9,47,16,158,79,130,76,189,158,183,161,FLAT
-86,3,94,97,34,56,72,85,3,5,-58,-86,16,8,-33,-83,76,14,-11,-70,161,84,72,-10,FLAT
22,22,1,23,97,34,56,72,-86,-71,3,22,-83,-66,-55,-64,-70,-63,-30,-61,-10,-57,-8,-48,FLAT
2,5,2,7,23,97,34,56,22,3,19,2,-64,-68,22,24,-61,-63,-36,-62,-48,-60,-11,-59,FLAT
32,35,7,42,7,23,97,34,2,37,2,32,24,40,21,34,-62,-31,24,56,-59,-26,-34,-30,FLAT
1,14,6,20,42,7,23,97,32,0,22,1,34,37,24,33,56,40,43,35,-30,-31,46,57,FLAT
-5,5,14,19,20,42,7,23,1,3,4,-5,33,3,26,-4,35,40,28,28,57,43,47,30,FLAT
4,27,5,32,19,20,42,7,-5,-5,-18,4,-4,-2,-14,-1,28,-2,8,0,30,35,10,32,FLAT
-19,9,19,28,32,19,20,42,4,-5,-1,-19,-1,-10,-19,-15,0,-7,-15,-20,32,-7,7,-19,FLAT
4,9,2,11,28,32,19,20,-19,-13,4,4,-15,-18,3,-15,-20,-23,-15,-11,-19,-20,-11,-16,FLAT
-3,0,5,5,11,28,32,19,4,0,6,-3,-15,-13,10,1,-11,-18,9,-18,-16,-23,-9,-14,FLAT
-6,4,12,16,5,11,28,32,-3,1,-10,-6,1,1,-4,-9,-18,-12,0,-5,-14,-17,-1,-24,FLAT
-13,0,17,17,16,5,11,28,-6,-8,-9,-13,-9,-7,-19,-19,-5,-7,-13,-22,-24,-20,-9,-18,FLAT
-2,15,4,19,31,30,28,24,-19,-20,-8,-2,3,-22,-11,-21,9,0,9,1,-12,-12,-7,7,FLAT
-25,16,26,42,19,31,30,28,-2,-3,-26,-25,-21,-23,-34,-27,1,-25,-37,-46,7,-3,-17,-24,FLAT
-8,1,21,22,42,19,31,30,-25,-13,7,-8,-27,-16,-19,-33,-46,-36,-27,-35,-24,-38,-30,-54,FLAT
32,34,16,50,22,42,19,31,-8,27,-1,32,-33,14,6,24,-35,11,-20,-1,-54,-9,-28,-3,FLAT
-29,3,35,38,50,22,42,19,32,-10,2,-29,24,17,1,3,-1,4,8,-5,-3,1,-18,-30,FLAT
-25,30,25,55,38,50,22,42,-29,-35,-52,-25,3,-45,-50,-54,-5,-18,-51,-22,-30,-31,-44,-30,FLAT
1,22,2,24,55,38,50,22,-25,-22,9,1,-54,-57,-43,-24,-22,-67,-41,-53,-30,-40,-42,-21,FLAT
41,51,5,56,41,24,55,38,14,23,8,41,15,58,26,55,-10,36,35,56,-39,1,-17,31,FLAT
-20,3,39,42,56,41,24,55,41,14,28,-20,55,37,36,21,56,72,54,35,31,50,63,36,FLAT
-8,11,29,40,42,56,41,24,-20,-18,-16,-8,21,-4,12,-28,35,19,20,13,36,54,38,27,FLAT
54,56,5,61,40,42,56,41,-8,30,9,54,-28,12,-7,46,13,26,21,26,27,49,29,67,FLAT
30,40,5,45,61,40,42,56,54,30,46,30,46,60,55,84,26,42,39,76,67,56,67,56,FLAT
37,44,19,63,45,61,40,42,30,51,33,37,84,81,79,67,76,111,88,121,56,93,72,113,FLAT
-14,1,45,46,63,45,61,40,37,12,29,-14,67,63,62,23,121,93,108,53,113,123,117,107,FLAT
17,25,7,32,46,63,45,61,-14,-21,-7,17,23,-9,22,3,53,42,55,40,107,72,101,70,FLAT
79,91,4,95,32,46,63,45,17,76,13,79,3,55,6,96,40,67,35,82,70,118,68,119,FLAT
-23,39,27,66,95,32,46,63,79,0,29,-23,96,76,42,56,82,55,35,73,119,67,64,59,FLAT
0,32,8,40,66,95,32,46,-23,-19,7,0,56,-19,36,-23,73,57,49,56,59,36,42,73,FLAT
-19,11,24,35,40,66,95,32,0,-3,2,-19,-23,-22,9,-19,56,-22,38,-42,73,54,51,37,FLAT
-6,32,6,38,35,40,66,95,-19,-24,-27,-6,-19,-27,-25,-25,-42,-46,-18,-25,37,-46,11,-48,FLAT
-9,26,10,36,38,35,40,66,-6,-5,-3,-9,-25,-29,-30,-15,-25,-32,-28,-34,-48,-51,-21,-34,FLAT
48,59,0,59,36,38,35,40,-9,38,15,48,-15,33,12,39,-34,9,-15,33,-34,6,-13,14,FLAT
-26,6,32,38,59,36,38,35,48,6,27,-26,39,44,42,22,33,39,39,13,14,15,12,7,FLAT
34,47,6,53,88,38,59,36,-72,-32,3,34,-98,-64,-79,-38,-50,-58,-52,-64,-59,-20,-37,-16,FLAT
1,30,10,40,53,88,38,59,34,5,18,1,-38,-27,21,35,-64,-59,-61,-37,-16,-53,-34,-63,FLAT
-6,22,20,42,40,53,88,38,1,4,2,-6,35,9,20,-5,-37,-23,23,29,-63,-55,-59,-43,FLAT
-59,2,79,81,33,42,40,53,-27,-12,-60,-59,-33,-27,-66,-86,-32,-23,-64,-92,2,-18,-46,-91,FLAT
-70,1,86,87,81,33,42,40,-59,-63,-69,-70,-86,-75,-129,-129,-92,-90,-135,-156,-91,-86,-133,-162,FLAT
40,110,1,111,87,81,33,42,-70,-45,-69,40,-129,-108,-138,-30,-156,-120,-198,-89,-162,-135,-204,-116,FLAT
-87,4,118,122,111,87,81,33,40,30,19,-87,-30,-15,-50,-47,-89,-78,-119,-117,-116,-90,-179,-176,FLAT
-194,54,221,275,122,111,87,81,-87,-91,-244,-194,-47,-61,-225,-281,-117,-106,-294,-241,-176,-169,-363,-311,FLAT
-76,52,86,138,275,122,111,87,-194,-211,-74,-76,-281,-302,-318,-270,-241,-272,-299,-357,-311,-317,-368,-317,FLAT
60,62,43,105,138,275,122,111,-76,17,50,60,-270,-194,-24,-16,-357,-285,-268,-210,-317,-255,-249,-297,FLAT
-188,18,189,207,105,138,275,122,60,-42,-144,-188,-16,-25,-94,-128,-210,-236,-168,-204,-297,-327,-412,-398,FLAT
40,62,33,95,207,105,138,275,-188,-116,-4,40,-128,-158,-148,-148,-204,-141,-98,-88,-398,-352,-172,-164,FLAT
-1,35,43,78,95,207,105,138,40,9,26,-1,-148,-107,22,39,-88,-149,-122,-149,-164,-132,-72,-89,FLAT
-92,38,97,135,78,95,207,105,-1,-38,-95,-92,39,-29,-69,-93,-149,-145,-73,-53,-89,-187,-217,-241,FLAT
-56,1,103,104,135,78,95,207,-92,-50,-19,-56,-93,-88,-114,-148,-53,-79,-88,-149,-241,-195,-92,-109,FLAT
27,85,29,114,104,135,78,95,-56,-47,-57,27,-148,-97,-76,-29,-149,-135,-171,-121,-109,-126,-145,-122,FLAT
-70,1,103,104,114,104,135,78,27,4,14,-70,-29,-43,-43,-43,-121,-93,-62,-99,-122,-131,-157,-191,FLAT
12,36,0,36,104,114,104,135,-70,-91,-23,12,-43,-87,-9,-58,-99,-134,-66,-31,-191,-184,-85,-87,FLAT
34,49,13,62,36,104,114,104,12,47,21,34,-58,-44,-2,46,-31,-40,12,-24,-87,-87,-45,3,FLAT
54,58,14,72,62,36,104,114,34,55,45,54,46,102,66,88,-24,11,43,100,3,15,57,30,FLAT
-14,10,55,65,72,62,36,104,54,27,34,-14,88,82,79,40,100,129,100,74,30,38,77,86,FLAT
-5,20,19,39,65,72,62,36,-14,-41,-15,-5,40,-14,19,-19,74,41,64,35,86,88,85,69,FLAT
-27,18,27,45,39,65,72,62,-5,-19,-25,-27,-19,-60,-40,-32,35,-33,-6,-46,69,22,39,8,FLAT
15,27,7,34,45,39,65,72,-27,-5,6,15,-32,-24,-19,-12,-46,-65,-34,-17,8,-38,0,-31,FLAT
46,48,3,51,70,34,45,39,57,38,57,46,72,99,82,103,45,94,88,118,40,75,63,91,FLAT
-33,2,47,49,51,70,34,45,46,11,13,-33,103,49,70,13,118,110,95,70,91,105,101,85,FLAT
59,59,2,61,49,51,70,34,-33,14,2,59,13,25,15,26,70,63,72,72,85,124,97,129,FLAT
22,29,11,40,61,49,51,70,59,31,52,22,26,45,54,81,72,56,67,48,129,94,124,94,FLAT
-39,0,44,44,40,61,49,51,22,-6,-10,-39,81,25,42,-17,48,39,44,42,94,50,57,9,FLAT
39,48,14,62,44,40,61,49,-39,9,-9,39,-17,3,-19,0,42,34,33,22,9,48,35,81,FLAT
7,22,11,33,45,49,41,27,-37,-23,-11,7,-40,-51,-35,-30,-16,-26,-18,-33,-17,-4,-10,-9,FLAT
36,36,6,42,33,45,49,41,7,31,22,36,-30,8,11,43,-33,-20,-13,6,-9,5,4,3,FLAT
-27,17,28,45,42,33,45,49,36,-5,-8,-27,43,26,14,9,6,3,3,16,3,-25,-21,-21,FLAT
10,10,11,21,45,42,33,45,-27,-7,17,10,9,-12,9,-17,16,19,31,19,-21,-4,20,26,FLAT
-10,9,18,27,21,45,42,33,10,-3,-9,-10,-17,-10,8,0,19,-15,0,-27,26,16,22,9,FLAT
15,15,15,30,27,21,45,42,-10,12,9,15,0,9,0,5,-27,2,17,15,9,-3,9,-12,FLAT
36,38,4,42,30,27,21,45,15,25,13,36,5,37,22,51,15,34,13,41,-12,27,30,51,FLAT
8,24,15,39,42,30,27,21,36,19,22,8,51,44,35,44,41,56,44,59,51,53,35,49,FLAT
58,69,2,71,39,42,30,27,8,45,13,58,44,64,35,66,59,89,48,102,49,101,57,117,FLAT
6,35,27,62,71,39,42,30,58,31,40,6,66,76,53,64,102,95,75,72,117,120,88,108,FLAT
-44,11,56,67,60,62,71,39,-52,-44,-51,-44,-46,-67,-72,-96,12,-36,-32,-90,20,9,-19,-32,FLAT
-10,34,10,44,67,60,62,71,-44,-56,-33,-10,-96,-100,-84,-54,-90,-123,-105,-106,-32,-92,-65,-100,FLAT
33,51,63,114,162,44,67,60,107,49,97,33,97,193,123,140,53,137,90,130,1,93,39,86,FLAT
36,79,18,97,114,162,44,67,33,-9,8,36,140,40,105,69,130,184,131,176,86,128,98,166,FLAT
-61,9,87,96,97,114,162,44,36,8,9,-61,69,-1,17,-25,176,48,114,8,166,192,140,115,FLAT
104,118,1,119,96,97,114,162,-61,18,-5,104,-25,26,4,43,8,17,12,79,115,66,109,112,FLAT
-43,0,65,65,119,96,97,114,104,21,75,-43,43,39,70,61,79,47,79,0,112,38,87,36,FLAT
6,64,16,80,65,119,96,97,-43,-43,-58,6,61,-22,17,-37,0,-4,12,67,36,4,21,6,FLAT
44,70,35,105,80,65,119,96,6,63,38,44,-37,20,-20,50,67,41,55,7,6,59,50,111,FLAT
19,25,54,79,105,80,65,119,44,38,64,19,50,101,102,63,7,58,44,69,111,79,119,26,FLAT
63,66,14,80,79,105,80,65,19,23,22,63,63,61,86,82,69,124,124,126,26,81,66,132,FLAT
-35,2,83,85,80,79,105,80,63,34,29,-35,82,57,51,28,126,95,115,47,132,158,153,91,FLAT
15,41,19,60,85,80,79,105,-35,-49,-24,15,28,-15,5,-20,47,8,27,43,91,46,91,62,FLAT
21,60,6,66,60,85,80,79,15,8,2,21,-20,-41,-22,36,43,-7,7,1,62,16,29,64,FLAT
-47,12,63,75,66,60,85,80,21,10,1,-47,36,18,3,-26,1,-31,-21,-11,64,3,8,-46,FLAT
69,90,0,90,75,66,60,85,-47,6,-9,69,-26,16,-8,22,-11,24,-6,43,-46,-25,-30,58,FLAT
54,66,40,106,90,75,66,60,69,94,78,54,22,100,69,123,43,110,70,76,58,118,72,97,FLAT
-49,7,55,62,82,78,106,90,-62,-67,-47,-49,-103,-113,-97,-111,-49,-137,-93,-152,20,-43,-15,-98,FLAT
-27,0,91,91,62,82,78,106,-49,9,-20,-27,-111,-58,-67,-76,-152,-104,-117,-138,-98,-128,-113,-179,FLAT
45,56,7,63,91,62,82,78,-27,-39,-11,45,-76,-30,-31,18,-138,-97,-78,-31,-179,-143,-128,-93,FLAT
-27,45,60,105,63,91,62,82,45,26,-16,-27,18,-13,-27,18,-31,-4,-47,-9,-93,-71,-94,-58,FLAT
58,58,19,77,105,63,91,62,-27,17,45,58,18,43,29,31,-9,4,18,76,-58,13,-2,49,FLAT
-5,1,62,63,77,105,63,91,58,38,52,-5,31,55,97,53,76,81,81,26,49,42,70,71,FLAT
10,57,11,68,63,77,105,63,-5,-41,-46,10,53,-3,6,5,26,14,51,63,71,40,35,36,FLAT
74,79,11,90,68,63,77,105,10,74,52,74,5,33,6,84,63,71,58,79,36,88,103,137,FLAT
-42,4,59,63,90,68,63,77,74,6,33,-42,84,80,85,32,79,39,39,42,137,77,91,37,FLAT
54,67,28,95,63,90,68,63,-42,23,-9,54,32,29,24,12,42,103,76,86,37,62,30,96,FLAT
29,29,36,65,95,63,90,68,54,37,67,29,12,60,58,83,86,66,91,41,96,140,143,115,FLAT
-36,6,62,68,87,64,65,95,-55,-57,-38,-36,-96,-92,-96,-91,-67,-106,-109,-132,-13,-69,-42,-103,FLAT
3,26,46,72,68,87,64,65,-36,-13,-17,3,-91,-70,-55,-33,-132,-105,-113,-88,-103,-119,-126,-129,FLAT
12,30,27,57,72,68,87,64,3,-7,8,12,-33,-20,-9,15,-88,-77,-47,-21,-129,-112,-105,-76,FLAT
-23,23,38,61,57,72,68,87,12,-12,-16,-23,15,-19,-8,-11,-21,-32,-25,-8,-76,-89,-63,-44,FLAT
-56,16,58,74,61,57,72,68,-23,-36,-49,-56,-11,-48,-65,-79,-8,-55,-57,-67,-44,-68,-74,-64,FLAT
14,36,7,43,74,61,57,72,-56,-37,-6,14,-79,-73,-55,-42,-67,-85,-71,-65,-64,-92,-63,-53,FLAT
-53,26,54,80,43,74,61,57,14,-6,-43,-53,-42,-43,-49,-39,-65,-79,-98,-95,-53,-91,-114,-118,FLAT
1,29,18,47,80,43,74,61,-53,-35,-2,1,-39,-41,-45,-52,-95,-78,-51,-38,-118,-114,-100,-94,FLAT
-21,14,35,49,47,80,43,74,1,-4,-6,-21,-52,-39,-8,-20,-38,-45,-51,-73,-94,-82,-57,-59,FLAT
-25,3,37,40,49,47,80,43,-21,-23,-14,-25,-20,-27,-20,-46,-73,-62,-22,-45,-59,-68,-65,-98,FLAT
34,37,2,39,40,49,47,80,-25,-1,0,34,-46,-24,-14,9,-45,-28,-20,-12,-98,-63,-22,-11,FLAT
49,50,4,54,70,39,40,49,56,40,56,49,90,107,92,105,65,106,92,139,44,83,78,114,FLAT
-12,6,14,20,40,29,52,72,38,0,20,-12,38,39,48,26,64,39,71,26,12,14,66,52,FLAT
24,44,2,46,20,40,29,52,-12,12,-14,24,26,12,6,12,26,51,34,50,52,51,57,50,FLAT
11,19,1,20,46,20,40,29,24,10,36,11,12,22,22,35,50,22,42,23,50,61,70,61,FLAT
0,20,2,22,20,46,20,40,11,1,-1,0,35,11,35,11,23,23,21,35,61,23,41,23,FLAT
-21,2,30,32,22,20,46,20,0,7,-3,-21,11,8,-4,-21,35,18,32,-10,23,30,18,14,FLAT
1,5,21,26,32,22,20,46,-21,-8,-2,1,-21,-1,-5,-20,-10,0,-6,-20,14,10,30,-9,FLAT
20,23,12,35,26,32,22,20,1,11,2,20,-20,3,0,21,-20,10,-3,0,-9,11,-4,0,FLAT
35,45,14,59,35,26,32,22,20,37,13,35,21,48,15,55,0,40,13,56,0,47,10,35,FLAT
42,51,4,55,59,35,26,32,35,32,36,42,55,69,49,77,56,80,51,97,35,72,49,98,FLAT
-76,11,96,107,55,59,35,26,42,16,-36,-76,77,48,0,-34,97,85,13,1,98,96,15,21,FLAT
-101,11,101,112,107,55,59,35,-76,-96,-101,-101,-34,-80,-137,-177,1,-48,-101,-135,21,-11,-88,-100,FLAT
19,36,2,38,112,107,55,59,-101,-80,-6,19,-177,-176,-107,-82,-135,-160,-143,-158,-100,-128,-107,-116,FLAT
71,72,8,80,38,112,107,55,19,77,35,71,-82,-3,29,90,-158,-99,-72,-11,-116,-83,-108,-87,FLAT
19,27,56,83,80,38,112,107,71,67,64,19,90,144,99,90,-11,64,93,109,-87,-32,-8,8,FLAT
-63,11,90,101,83,80,38,112,19,-29,-47,-63,90,38,17,-44,109,115,52,27,8,35,46,46,FLAT
31,60,2,62,101,83,80,38,-63,-57,-18,31,-44,-86,-65,-32,27,-19,-1,-13,46,58,34,58,FLAT
14,21,32,53,62,101,83,80,31,44,53,14,-32,-13,35,45,-13,-42,-12,-18,58,25,52,1,FLAT
14,44,20,64,53,62,101,83,14,2,-9,14,45,46,44,28,-18,-11,26,59,1,-40,-21,-4,FLAT
-68,15,80,95,64,53,62,101,14,-8,-39,-68,28,-6,-48,-54,59,38,5,-40,-4,-19,-13,-9,FLAT
9,42,22,64,95,64,53,62,-68,-49,-18,9,-54,-57,-57,-59,-40,-55,-66,-45,-9,-11,-13,-31,FLAT
16,50,21,71,64,95,64,53,9,15,8,16,-59,-34,-10,25,-45,-42,-49,-43,-31,-40,-58,-29,FLAT
11,28,19,47,71,64,95,64,16,9,33,11,25,24,41,27,-43,-25,23,36,-29,-33,-16,-32,FLAT
-6,25,27,52,47,71,64,95,11,2,-3,-6,27,11,30,5,36,26,38,21,-32,-23,20,30,FLAT
27,64,1,65,52,47,71,64,-6,1,-12,27,5,3,-15,21,21,12,18,32,30,27,26,48,FLAT
9,32,14,46,65,52,47,71,27,22,41,9,21,23,29,36,32,25,26,30,48,34,59,41,FLAT
38,49,43,92,46,65,52,47,9,67,21,38,36,89,62,47,30,90,50,74,41,92,47,68,FLAT
-70,1,76,77,92,46,65,52,38,-37,-22,-70,47,30,-1,-32,74,52,40,-23,68,53,28,4,FLAT
32,32,30,62,77,92,46,65,-70,-14,1,32,-32,-51,-21,-38,-23,16,0,0,4,38,41,9,FLAT
-33,0,65,65,62,77,92,46,32,2,-1,-33,-38,-12,0,-1,0,-49,-22,-71,9,18,-1,-33,FLAT
-18,11,34,45,65,62,77,92,-33,-49,-29,-18,-1,-47,-30,-51,-71,-61,-29,-19,-33,-98,-51,-89,FLAT
38,45,1,46,45,65,62,77,-18,5,4,38,-51,-44,-25,20,-19,-42,-26,-13,-89,-56,-25,19,FLAT
1,17,41,58,46,45,65,62,38,41,29,1,20,46,33,39,-13,-3,4,21,19,-1,3,-12,FLAT
-42,16,46,62,58,46,45,65,1,-37,-41,-42,39,4,-12,-41,21,9,-8,-3,-12,-40,-37,-21,FLAT
-2,26,18,44,62,58,46,45,-42,-30,-12,-2,-41,-67,-53,-44,-3,-26,-24,-43,-21,-21,-20,-5,FLAT
480,484,179,663,51,44,62,58,17,628,16,480,15,658,39,497,-27,628,27,495,-26,591,-14,453,FLAT
-79,28,148,176,663,51,44,62,480,-110,377,-79,497,518,393,401,495,548,416,418,453,518,404,416,FLAT
100,160,24,184,176,663,51,44,-79,-24,-32,100,401,-134,345,21,418,494,361,501,416,524,384,518,FLAT
41,59,58,117,184,176,663,51,100,75,142,41,21,51,110,141,501,-59,487,62,518,569,503,542,FLAT
-59,24,157,181,117,184,176,663,41,40,-24,-59,141,115,118,-18,62,91,86,82,542,-19,463,3,FLAT
24,102,44,146,181,117,184,176,-59,-89,-54,24,-18,-49,-78,-35,82,26,64,6,3,2,32,106,FLAT
192,217,1,218,146,181,117,184,24,149,77,192,-35,60,23,216,6,100,-1,157,106,175,141,198,FLAT
-8,52,69,121,218,146,181,117,192,60,157,-8,216,209,234,184,157,120,180,208,198,160,156,149,FLAT
-26,80,53,133,121,218,146,181,-8,-42,-54,-26,184,18,103,-34,208,167,180,158,149,78,126,182,FLAT
-144,5,200,205,133,121,218,146,-26,3,-69,-144,-34,-39,-123,-170,158,21,34,-178,182,170,111,14,FLAT
-19,39,56,95,205,133,121,218,-144,-163,-53,-19,-170,-160,-122,-163,-178,-202,-176,-189,14,-142,-19,-197,FLAT
57,70,8,78,95,205,133,121,-19,9,26,57,-163,-154,-27,38,-189,-151,-96,-106,-197,-193,-150,-132,FLAT
-16,35,18,53,78,95,205,133,57,-6,19,-16,38,3,45,41,-106,-160,-8,22,-132,-157,-77,-122,FLAT
82,85,11,96,53,78,95,205,-16,75,32,82,41,69,51,66,22,78,77,123,-122,-85,24,104,FLAT
79,95,11,106,96,53,78,95,82,79,69,79,66,154,101,161,123,148,120,145,104,157,146,202,FLAT
-13,0,26,26,106,96,53,78,79,2,82,-13,161,81,151,66,145,156,183,148,202,150,202,132,FLAT
-23,12,36,48,26,106,96,53,-13,-13,-35,-23,66,-11,47,-36,148,68,116,43,132,143,148,125,FLAT
52,52,4,56,48,26,106,96,-23,20,12,52,-36,7,-23,29,43,9,59,16,125,88,128,95,FLAT
-3,32,19,51,56,48,26,106,52,12,17,-3,29,32,29,49,16,19,-6,26,95,21,76,13,FLAT
10,10,12,22,51,56,48,26,-3,3,32,10,49,15,49,7,26,35,61,59,13,22,26,36,FLAT
11,30,11,41,22,51,56,48,10,10,-9,11,7,13,23,21,59,25,40,18,36,45,52,70,FLAT
-37,12,43,55,41,22,51,56,11,-5,-19,-37,21,5,-28,-26,18,8,4,-16,70,20,21,-19,FLAT
3,13,12,25,49,50,91,42,13,-20,4,3,34,9,34,16,-47,-35,31,37,-82,-71,-54,-44,FLAT
33,33,5,38,25,49,50,91,3,26,13,33,16,6,17,36,37,35,47,49,-44,-9,44,70,FLAT
-5,5,23,28,38,25,49,50,33,13,23,-5,36,39,36,28,49,19,40,31,70,48,70,44,FLAT
-17,8,20,28,28,38,25,49,-5,-20,-20,-17,28,-7,3,-22,31,19,16,11,44,-1,20,14,FLAT
5,20,6,26,28,28,38,25,-17,-9,-7,5,-22,-29,-27,-12,11,-16,-4,-17,14,10,9,16,FLAT
-39,0,45,45,26,28,28,38,5,0,-19,-39,-12,-9,-26,-34,-17,-29,-46,-51,16,-16,-23,-56,FLAT
19,28,4,32,45,26,28,28,-39,-22,-9,19,-34,-22,-28,-20,-51,-31,-35,-15,-56,-51,-55,-32,FLAT
-22,1,33,34,32,45,26,28,19,7,5,-22,-20,-15,-4,-3,-15,-15,-23,-42,-32,-24,-30,-37,FLAT
-19,10,31,41,34,32,45,26,-22,-21,-28,-19,-3,-14,-23,-41,-42,-36,-32,-22,-37,-36,-51,-61,FLAT
8,21,14,35,41,34,32,45,-19,-9,-3,8,-41,-30,-31,-11,-22,-23,-26,-33,-61,-45,-35,-14,FLAT
23,24,20,44,35,41,34,32,8,29,20,23,-11,20,17,31,-33,-1,-11,12,-14,6,-6,-10,FLAT
-8,10,31,41,44,35,41,34,23,3,6,-8,31,32,26,15,12,23,23,23,-10,2,-5,4,FLAT
-53,44,106,150,41,44,35,41,-8,22,-87,-53,15,25,-81,-61,23,54,-61,-38,4,45,-64,-30,FLAT
18,55,9,64,166,150,41,44,166,27,129,18,113,87,173,184,105,109,86,131,128,112,92,123,FLAT
-14,11,28,39,64,166,150,41,18,5,30,-14,184,32,159,4,131,92,203,170,123,114,116,117,FLAT
14,39,9,48,39,64,166,150,-14,-5,-14,14,4,0,16,0,170,27,145,18,117,87,189,184,FLAT
178,178,80,258,48,39,64,166,14,249,39,178,0,244,25,192,18,249,55,178,184,276,184,196,FLAT
3,31,39,70,258,48,39,64,178,-38,150,3,192,211,189,181,178,206,175,195,196,211,205,181,FLAT
29,53,15,68,70,258,48,39,3,5,7,29,181,-33,157,32,195,216,196,210,181,211,182,224,FLAT
-56,22,57,79,68,70,258,48,29,-14,-25,-56,32,-9,-18,-27,210,-47,132,-24,224,202,171,154,FLAT
2,42,2,44,79,68,70,258,-56,-53,-18,2,-27,-67,-43,-54,-24,-62,-36,-25,154,-100,114,-22,FLAT
86,96,4,100,44,79,68,70,2,88,32,86,-54,35,14,88,-25,21,-11,32,-22,26,-4,61,FLAT
-15,5,98,103,100,44,79,68,86,79,76,-15,88,167,108,71,32,114,90,73,61,100,65,17,FLAT
12,29,43,72,103,100,44,79,-15,-43,-12,12,71,36,64,-3,73,124,96,83,17,71,78,85,FLAT
-3,2,38,40,72,103,100,44,12,-8,24,-3,-3,-51,12,9,83,28,88,-6,85,116,120,80,FLAT
-57,18,61,79,40,72,103,100,-3,-34,-73,-57,9,-42,-49,-60,-6,-85,-61,-48,80,-6,15,-63,FLAT
-12,4,60,64,79,40,72,103,-57,-13,2,-12,-60,-47,-71,-69,-48,-55,-47,-72,-63,-98,-59,-60,FLAT
-18,11,61,72,64,79,40,72,-12,-17,-25,-18,-69,-30,-23,-30,-72,-64,-96,-87,-60,-72,-72,-90,FLAT
-15,9,41,50,72,64,79,40,-18,-35,-13,-15,-30,-52,-38,-33,-87,-65,-36,-45,-90,-99,-109,-102,FLAT
33,44,20,64,50,72,64,79,-15,12,-2,33,-33,-23,-15,18,-45,-40,-40,0,-102,-53,-38,-12,FLAT
-9,6,34,40,64,50,72,64,33,5,29,-9,18,17,27,24,0,-18,14,9,-12,-35,-11,-9,FLAT
-51,18,73,91,40,64,50,72,-9,-12,-63,-51,24,-7,-34,-60,9,5,-36,-27,-9,-30,-49,-42,FLAT
57,74,20,94,91,40,64,50,-51,4,1,57,-60,-8,-62,6,-27,-3,-33,-3,-42,9,-35,30,FLAT
104,106,146,252,71,94,91,40,39,218,37,104,96,269,111,143,45,273,112,200,36,261,49,149,FLAT
189,198,48,246,252,71,94,91,104,91,97,189,143,309,134,293,200,360,208,332,149,364,209,389,FLAT
-13,41,88,129,246,252,71,94,189,27,144,-13,293,118,241,176,332,336,278,280,389,387,352,319,FLAT
65,109,2,111,129,246,252,71,-13,-21,-3,65,176,6,141,52,280,97,238,241,319,315,275,345,FLAT
110,121,13,134,111,129,246,252,65,121,98,110,52,100,95,175,241,127,239,162,345,218,336,351,FLAT
-7,64,33,97,134,111,129,246,110,13,50,-7,175,134,148,103,162,113,145,168,351,140,289,155,FLAT
-9,61,68,129,163,97,134,111,-101,-57,-23,-9,-108,-75,-107,-110,2,-62,-57,-117,67,59,41,-7,FLAT
-46,1,96,97,129,163,97,134,-9,-18,14,-46,-110,-75,-9,-55,-117,-93,-93,-156,-7,-80,-43,-163,FLAT
-18,24,33,57,97,129,163,97,-46,-81,-41,-18,-55,-99,-27,-64,-156,-156,-50,-73,-163,-174,-134,-174,FLAT
49,59,23,82,57,97,129,163,-18,39,14,49,-64,-42,-27,31,-73,-60,-13,-15,-174,-117,-36,-24,FLAT
25,51,2,53,82,57,97,129,49,4,33,25,31,43,47,74,-15,-38,6,56,-24,-56,20,10,FLAT
36,60,13,73,53,82,57,97,25,47,27,36,74,51,60,61,56,90,74,110,10,9,33,92,FLAT
-52,8,88,96,73,53,82,57,36,23,0,-52,61,70,27,-16,110,74,60,9,92,113,74,58,FLAT
-8,44,12,56,96,73,53,82,-52,-84,-44,-8,-16,-61,-44,-60,9,-14,-17,-24,58,-10,16,1,FLAT
38,40,13,53,56,96,73,53,-8,39,42,38,-60,-45,-2,30,-24,-22,-2,-22,1,25,25,14,FLAT
-53,10,62,72,53,56,96,73,38,-4,-23,-53,30,35,19,-15,-22,-49,-25,-23,14,-26,-25,-75,FLAT
50,60,1,61,72,53,56,96,-53,-11,0,50,-15,-15,-23,-3,-23,24,19,35,-75,-60,-25,27,FLAT
24,47,19,66,61,72,53,56,50,42,37,24,-3,31,37,74,35,27,14,21,27,66,56,59,FLAT
-74,3,74,77,66,61,72,53,24,-19,-30,-74,74,23,7,-50,21,12,7,0,59,8,-16,-53,FLAT
41,41,9,50,77,66,61,72,-74,-24,3,41,-50,-43,-27,-33,0,-1,10,-9,-53,-12,10,41,FLAT
-18,8,32,40,50,77,66,61,41,5,15,-18,-33,-19,18,23,-9,-38,-12,-51,41,4,25,-27,FLAT
-8,18,17,35,67,35,41,41,35,-15,17,-8,25,19,19,27,9,18,24,17,35,8,14,1,FLAT
8,35,0,35,35,67,35,41,-8,-9,-9,8,27,-24,8,0,17,10,10,35,1,9,15,25,FLAT
-2,7,18,25,35,35,67,35,8,16,26,-2,0,7,17,6,35,-8,34,-2,25,26,36,33,FLAT
-14,9,19,28,25,35,35,67,-2,-13,-16,-14,6,3,10,-16,-2,-6,1,-8,33,-21,18,-16,FLAT
-7,3,25,28,28,25,35,35,-14,-1,-1,-7,-16,-14,-17,-21,-8,2,9,-23,-16,-7,0,-15,FLAT
-8,10,23,33,28,28,25,35,-7,-10,-15,-8,-21,-11,-16,-15,-23,-24,-32,-29,-15,-8,-6,-31,FLAT
19,30,16,46,33,28,28,25,-8,12,-1,19,-15,2,-16,11,-29,1,-17,4,-31,-12,-33,-10,FLAT
-66,14,68,82,46,33,28,28,19,-14,-50,-66,11,-2,-51,-47,4,-12,-66,-55,-10,-13,-67,-62,FLAT
110,112,3,115,82,46,33,28,-66,45,12,110,-47,31,-38,44,-55,43,-39,63,-62,33,-54,55,FLAT
-60,15,73,88,115,82,46,33,110,10,37,-60,44,55,49,50,63,41,-1,-16,55,53,-2,3,FLAT
-15,18,32,50,88,115,82,46,-60,-56,-18,-15,50,-46,19,-75,-16,-1,31,35,3,-15,-19,-31,FLAT
28,33,8,41,50,88,115,82,-15,4,13,28,-75,-52,-5,13,35,-42,32,-47,-31,3,44,63,FLAT
59,59,8,67,89,72,41,50,-62,-9,13,59,-90,-29,-24,-3,-62,-31,-57,-31,-77,-27,-44,-3,FLAT
3,27,45,72,67,89,72,41,59,40,35,3,-3,31,48,62,-31,11,11,0,-3,9,-22,-28,FLAT
-16,25,33,58,72,67,89,72,3,-28,-14,-16,62,12,21,-13,0,3,34,46,-28,-17,-3,-16,FLAT
-82,18,91,109,58,72,67,89,-16,-24,-75,-82,-13,-52,-89,-98,46,-12,-54,-95,-16,-21,-41,-36,FLAT
-23,10,46,56,109,58,72,67,-82,-68,-15,-23,-98,-92,-90,-105,-95,-120,-104,-121,-36,-80,-69,-118,FLAT
59,61,27,88,56,109,58,72,-23,40,8,59,-105,-28,-7,36,-121,-52,-82,-46,-118,-80,-96,-62,FLAT
-17,18,32,50,88,56,109,58,59,-12,26,-17,36,28,34,42,-46,-40,19,19,-62,-64,-56,-63,FLAT
0,14,21,35,50,88,56,109,-17,-11,4,0,42,-23,30,-17,19,17,38,42,-63,-51,23,19,FLAT
10,10,45,55,35,50,88,56,0,34,14,10,-17,23,18,10,42,11,44,-7,19,51,52,52,FLAT
7,53,27,80,55,35,50,88,10,-11,-36,7,10,23,-22,17,-7,12,-18,17,52,0,8,0,FLAT
21,49,12,61,80,55,35,50,7,6,25,21,17,-5,-11,28,17,29,3,38,0,18,7,38,FLAT
-19,32,37,69,61,80,55,35,21,6,-2,-19,28,12,23,2,38,1,-13,9,38,35,1,19,FLAT
37,39,20,59,69,61,80,55,-19,20,30,37,2,26,28,18,9,32,53,39,19,21,17,46,FLAT
-49,17,58,75,59,69,61,80,37,-11,-27,-49,18,9,3,-12,39,15,1,-31,46,21,26,-10,FLAT
-11,23,37,60,75,59,69,61,-49,-32,-17,-11,-12,-43,-44,-60,-31,-23,-14,-23,-10,-17,-16,-42,FLAT
-90,20,91,111,60,75,59,69,-11,-36,-87,-90,-60,-68,-104,-101,-23,-79,-131,-150,-42,-59,-101,-113,FLAT
27,37,5,42,111,60,75,59,-90,-59,10,27,-101,-95,-77,-63,-150,-127,-94,-74,-113,-138,-121,-123,FLAT
-4,42,8,50,42,111,60,75,27,-1,-9,-4,-63,-60,1,23,-74,-96,-86,-67,-123,-128,-103,-78,FLAT
20,30,20,50,50,42,111,60,-4,32,32,20,23,31,23,16,-67,-28,33,43,-78,-64,-54,-47,FLAT
45,53,5,58,50,50,42,111,20,30,22,45,16,62,54,65,43,61,45,61,-47,2,55,88,FLAT
-18,3,41,44,58,50,50,42,45,18,32,-18,65,48,54,27,61,80,86,47,88,79,77,43,FLAT
-331,9,507,516,44,58,50,50,-18,135,-337,-331,27,153,-305,-349,47,183,-283,-304,43,215,-251,-284,FLAT
110,161,1,162,516,44,58,50,-331,-396,-42,110,-349,-261,-379,-221,-304,-243,-347,-239,-284,-213,-325,-194,FLAT
-85,6,104,110,162,516,44,58,110,18,70,-85,-221,-378,28,25,-239,-243,-309,-306,-194,-225,-277,-324,FLAT
-13,35,62,97,110,162,516,44,-85,-55,-42,-13,25,-37,28,-98,-306,-433,-14,12,-324,-298,-351,-319,FLAT
32,69,28,97,97,110,162,516,-13,-2,-2,32,-98,-57,-44,19,12,-39,26,-66,-319,-435,-16,44,FLAT
23,119,16,135,97,97,110,162,32,11,-27,23,19,9,-29,55,-66,-46,-71,42,44,-28,-1,-43,FLAT
-160,117,161,278,135,97,97,110,23,-15,-158,-160,55,-4,-185,-137,42,-6,-187,-105,-43,-61,-229,-118,FLAT
-102,38,128,166,278,135,97,97,-160,-135,-23,-102,-137,-150,-181,-262,-105,-139,-208,-239,-118,-141,-210,-207,FLAT
8,86,14,100,166,278,135,97,-102,-106,-40,8,-262,-241,-63,-94,-239,-256,-221,-254,-207,-245,-248,-231,FLAT
14,39,23,62,100,166,278,135,8,23,61,14,-94,-83,21,22,-254,-218,-2,-80,-231,-233,-160,-240,FLAT
-12,61,46,107,62,100,166,278,14,11,-34,-12,22,34,27,2,-80,-72,-13,10,-240,-207,-36,-92,FLAT
-162,30,169,199,107,62,100,166,-12,-39,-131,-162,2,-28,-165,-174,10,-5,-104,-160,-92,-111,-144,-152,FLAT
-80,19,105,124,199,107,62,100,-162,-144,-69,-80,-174,-183,-200,-242,-160,-172,-234,-254,-152,-149,-173,-240,FLAT
-20,36,40,76,124,199,107,62,-80,-85,-37,-20,-242,-229,-106,-100,-254,-268,-237,-262,-240,-257,-271,-274,FLAT
41,53,23,76,76,124,199,107,-20,24,24,41,-100,-61,-13,21,-262,-205,-82,-59,-274,-244,-213,-221,FLAT
-29,0,44,44,76,76,124,199,41,-8,24,-29,21,16,48,12,-59,-69,11,-8,-221,-213,-58,-88,FLAT
-65,2,70,72,44,76,76,124,-29,-39,-67,-65,12,-47,-43,-94,-8,-23,-19,-53,-88,-108,-56,-73,FLAT
41,55,10,65,72,44,76,76,-65,-19,-12,41,-94,-58,-79,-24,-53,-66,-55,-53,-73,-42,-31,-12,FLAT
39,39,26,65,99,65,72,44,55,45,79,39,96,110,110,94,31,91,98,135,2,52,31,70,FLAT
-9,9,30,39,65,99,65,72,39,-5,21,-9,94,40,100,30,135,105,131,85,70,86,119,126,FLAT
10,15,29,44,39,65,99,65,-9,9,4,10,30,4,25,1,85,49,104,40,126,114,135,95,FLAT
-26,1,29,30,29,13,28,51,1,-1,-2,-26,5,-3,-20,-25,-19,-18,-20,-21,3,-26,-5,-45,FLAT
36,43,0,43,30,29,13,28,-26,7,-6,36,-25,6,-8,10,-21,4,-26,11,-45,-11,-26,15,FLAT
0,3,20,23,43,30,29,13,36,20,40,0,10,27,34,36,11,26,32,10,15,24,14,11,FLAT
28,33,5,38,23,43,30,29,0,13,-2,28,36,33,38,28,10,40,32,64,11,39,30,38,FLAT
17,30,3,33,38,23,43,30,28,15,20,17,28,28,18,45,64,48,58,45,38,55,52,81,FLAT
18,22,26,48,33,38,23,43,17,41,26,18,45,56,46,35,45,69,44,63,81,89,84,63,FLAT
17,22,0,22,48,33,38,23,18,-9,17,17,35,32,43,35,63,47,63,52,63,60,61,80,FLAT
46,47,15,62,22,48,33,38,17,61,21,46,35,52,38,63,52,93,64,81,80,108,84,98,FLAT
-38,0,60,60,62,22,48,33,46,7,9,-38,63,68,30,8,81,59,47,25,98,100,73,43,FLAT
36,41,9,50,60,62,22,48,-38,-15,-5,36,8,-8,4,-2,25,53,25,44,43,44,42,61,FLAT
-36,52,48,100,50,60,62,22,36,3,-47,-36,-2,-12,-52,0,44,-5,-43,-38,61,56,-22,8,FLAT
-5,20,15,35,100,50,60,62,-36,-38,27,-5,0,-35,-20,-41,-38,-50,-25,-5,8,-43,-16,-43,FLAT
-15,26,40,66,35,100,50,60,-5,10,-21,-15,-41,-28,6,-20,-5,-25,-41,-56,-43,-40,-46,-20,FLAT
100,104,20,124,66,35,100,50,-15,80,22,100,-20,90,1,85,-56,52,28,80,-20,55,-19,44,FLAT
-26,31,42,73,124,66,35,100,100,-4,47,-26,85,76,69,74,80,86,48,59,44,48,75,54,FLAT
-1,8,40,48,97,73,124,66,-21,-38,11,-1,-47,-24,1,-22,53,-28,48,-48,38,52,70,52,FLAT
-80,18,88,106,111,48,97,73,-69,-74,-69,-80,-70,-101,-159,-149,-91,-139,-148,-150,-117,-125,-158,-171,FLAT
-47,26,65,91,106,111,48,97,-80,-70,-55,-47,-149,-144,-124,-127,-150,-171,-214,-196,-171,-209,-203,-197,FLAT
-75,8,85,93,91,106,111,48,-47,-55,-57,-75,-127,-125,-112,-122,-196,-199,-181,-202,-197,-226,-271,-271,FLAT
67,73,39,112,93,91,106,111,-75,21,2,67,-122,-34,-55,-8,-202,-104,-110,-55,-271,-178,-179,-135,FLAT
39,107,11,118,112,93,91,106,67,11,5,39,-8,32,7,106,-55,-23,-50,31,-135,-93,-105,-16,FLAT
36,44,8,52,118,112,93,91,39,33,99,36,106,44,104,75,31,65,106,142,-16,10,49,67,FLAT
15,40,42,82,52,118,112,93,36,49,19,15,75,82,118,51,142,93,123,90,67,114,125,157,FLAT
-64,19,65,84,82,52,118,112,15,-41,-43,-64,51,8,-24,-49,90,41,75,-13,157,52,80,26,FLAT
51,56,4,60,84,82,52,118,-64,-10,14,51,-49,-51,-29,-13,-13,-2,-10,2,26,31,89,38,FLAT
35,36,15,51,60,84,82,52,51,46,55,35,-13,36,69,86,2,-5,26,22,38,44,45,37,FLAT
-10,6,32,38,51,60,84,82,35,7,20,-10,86,53,75,25,22,43,89,76,37,2,46,12,FLAT
10,21,16,37,38,51,60,84,-10,-6,-5,10,25,1,15,0,76,47,70,35,12,37,84,86,FLAT
-80,9,80,89,37,38,51,60,10,-16,-68,-80,0,-22,-73,-70,35,-15,-53,-80,86,31,2,-45,FLAT
2,26,16,42,89,37,38,51,-80,-62,-15,2,-70,-78,-83,-78,-80,-84,-88,-68,-45,-77,-68,-78,FLAT
19,30,28,58,42,89,37,38,2,31,15,19,-78,-31,0,21,-68,-47,-68,-59,-78,-53,-73,-49,FLAT
31,45,13,58,58,42,89,37,19,16,16,31,21,47,31,50,-59,-15,16,52,-49,-31,-52,-28,FLAT
15,48,29,77,58,58,42,89,31,31,12,15,50,47,28,46,52,78,43,65,-28,16,28,67,FLAT
-126,20,128,148,156,77,58,58,-152,-150,-142,-126,-137,-179,-250,-278,-106,-148,-238,-263,-87,-132,-222,-232,FLAT
9,40,25,65,148,156,77,58,-126,-94,-11,9,-278,-244,-153,-117,-263,-273,-261,-269,-232,-242,-249,-254,FLAT
-94,60,101,161,65,148,156,77,9,-18,-114,-94,-117,-112,-125,-85,-269,-262,-267,-211,-254,-291,-375,-363,FLAT
33,33,53,86,161,65,148,156,-94,-15,60,33,-85,-33,-54,-61,-211,-127,-65,-52,-363,-277,-207,-178,FLAT
-162,25,167,192,86,161,65,148,33,-48,-154,-162,-61,-63,-94,-129,-52,-81,-208,-223,-178,-175,-219,-214,FLAT
-102,26,138,164,192,86,161,65,-162,-131,-103,-102,-129,-179,-257,-264,-223,-194,-197,-231,-214,-212,-311,-325,FLAT
19,19,55,74,164,192,86,161,-102,-64,26,19,-264,-195,-77,-83,-231,-243,-231,-245,-325,-258,-171,-212,FLAT
-71,77,87,164,74,164,192,86,19,-39,-129,-71,-83,-103,-103,-52,-245,-234,-206,-154,-212,-282,-360,-316,FLAT
-26,29,62,91,164,74,164,192,-71,-51,22,-26,-52,-90,-107,-97,-154,-154,-81,-78,-316,-285,-184,-180,FLAT
11,13,49,62,91,164,74,164,-26,-2,27,11,-97,-53,49,-15,-78,-92,-80,-86,-180,-156,-54,-67,FLAT
11,22,76,98,62,91,164,74,11,38,2,11,-15,36,29,22,-86,-15,51,-4,-67,-54,-78,-75,FLAT
-25,16,76,92,98,62,91,164,11,-25,-19,-25,22,13,-17,-14,-4,11,10,-3,-75,-40,32,-29,FLAT
0,18,46,64,92,98,62,91,-25,-30,-2,0,-14,-55,-21,-25,-3,-17,-19,-14,-29,-19,8,-3,FLAT
-21,12,32,44,64,92,98,62,0,-35,-15,-21,-25,-65,-17,-21,-14,-90,-36,-46,-3,-52,-34,-35,FLAT
21,26,6,32,44,64,92,98,-21,-5,7,21,-21,-40,-8,0,-46,-70,-10,0,-35,-95,-29,-25,FLAT
2,7,39,46,32,44,64,92,21,35,21,2,0,30,28,23,0,-5,13,2,-25,-35,11,2,FLAT
-24,0,41,41,46,32,44,64,2,-22,-17,-24,23,13,4,-22,2,8,11,-1,2,-27,-4,-22,FLAT
94,95,4,99,41,46,32,44,-24,57,-1,94,-22,35,-18,70,-1,70,3,72,-22,65,10,93,FLAT
-5,12,5,17,31,30,57,39,-19,-21,-7,-5,-23,-28,-15,-24,22,-26,14,-28,48,15,37,17,FLAT
13,26,7,33,17,31,30,57,-5,15,-1,13,-24,-6,-8,8,-28,-13,-16,-11,17,-11,13,-15,FLAT
-13,1,20,21,33,17,31,30,13,0,12,-13,8,15,11,0,-11,-6,4,-5,-15,-13,-4,-24,FLAT
-15,4,18,22,21,33,17,31,-13,-17,-18,-15,0,-17,-6,-28,-5,-2,-7,-15,-24,-23,-14,-20,FLAT
26,31,1,32,22,21,33,17,-15,9,-1,26,-28,-8,-19,11,-15,-8,-7,-2,-20,7,-8,11,FLAT
-17,9,35,44,32,22,21,33,26,17,5,-17,11,26,4,9,-2,9,-14,-6,11,9,-2,-19,FLAT
33,38,2,40,44,32,22,21,-17,0,4,33,9,17,9,16,-6,26,8,42,-19,9,-10,27,FLAT
14,22,18,40,40,44,32,22,33,30,30,14,16,30,34,47,42,47,39,30,27,56,38,56,FLAT
23,28,16,44,40,40,44,32,14,21,17,23,47,51,47,37,30,51,51,70,56,68,56,53,FLAT
-33,27,60,87,44,40,40,44,23,11,-32,-33,37,32,-15,-10,70,62,15,4,53,62,19,37,FLAT
14,51,1,52,87,44,40,40,-33,-45,-10,14,-10,-34,-42,-19,4,-13,-25,4,37,17,5,18,FLAT
59,76,34,110,71,52,87,44,29,57,18,59,43,121,63,88,10,76,53,102,33,87,21,69,FLAT
28,52,17,69,110,71,52,87,59,11,52,28,88,68,70,87,102,132,115,116,69,87,105,130,FLAT
78,80,10,90,69,110,71,52,28,71,50,78,87,82,102,106,116,139,120,165,130,203,165,194,FLAT
-7,19,49,68,90,69,110,71,78,32,54,-7,106,103,104,71,165,114,156,99,194,171,174,158,FLAT
113,125,7,132,68,90,69,110,-7,71,7,113,71,103,61,106,99,174,111,184,158,185,163,212,FLAT
12,50,40,90,132,68,90,69,113,45,87,12,106,116,94,125,184,148,148,118,212,219,198,196,FLAT
-24,14,78,92,90,132,68,90,12,14,12,-24,125,59,99,-12,118,130,106,101,196,162,160,94,FLAT
44,44,27,71,92,90,132,68,-24,-7,14,44,-12,7,26,20,101,52,113,32,94,123,120,145,FLAT
75,75,18,93,71,92,90,132,44,66,44,75,20,59,58,119,32,73,70,95,145,118,157,107,FLAT
-37,46,37,83,93,71,92,90,75,-18,-8,-37,119,48,36,38,95,41,50,82,107,55,62,58,FLAT
-30,11,87,98,83,93,71,92,-37,20,5,-30,38,2,-3,-67,82,68,41,8,58,61,55,52,FLAT
19,44,4,48,58,98,83,93,-14,-18,-8,19,-44,-78,-28,5,-81,-58,-23,-25,-6,-76,-31,-62,FLAT
-15,42,20,62,48,58,98,83,19,1,-13,-15,5,-17,-21,4,-25,-77,-41,-10,-62,-57,-36,-40,FLAT
15,24,22,46,62,48,58,98,-15,17,33,15,4,18,20,0,-10,0,12,19,-40,-60,-8,5,FLAT
6,24,11,35,46,62,48,58,15,-5,6,6,0,12,39,21,19,13,26,6,5,-5,18,25,FLAT
29,51,17,68,35,46,62,48,6,35,2,29,21,30,8,35,6,47,41,50,25,48,28,35,FLAT
-18,21,21,42,68,35,46,62,29,-14,12,-18,35,21,14,11,50,16,20,17,35,33,53,32,FLAT
-71,8,71,79,42,68,35,46,-18,-21,-58,-71,11,-35,-46,-89,17,0,-44,-60,32,-5,-38,-54,FLAT
42,50,5,55,79,42,68,35,-71,-24,0,42,-89,-45,-58,-29,-60,-59,-46,-47,-54,-24,-44,-18,FLAT
-74,5,76,81,55,79,42,68,42,-3,-29,-74,-29,-27,-29,-32,-47,-48,-87,-103,-18,-62,-75,-121,FLAT
21,28,48,76,81,55,79,42,-74,-7,-2,21,-32,-10,-31,-53,-103,-34,-31,-11,-121,-55,-89,-82,FLAT
37,54,27,81,76,81,55,79,21,16,11,37,-53,9,9,58,-11,6,-20,-16,-82,-18,-20,26,FLAT
-44,37,106,143,81,76,81,55,37,35,-27,-44,58,51,-16,-7,-16,44,-18,14,26,41,-47,-60,FLAT
-117,14,118,132,143,81,76,81,-44,-105,-94,-117,-7,-70,-121,-161,14,-54,-110,-124,-60,-61,-112,-103,FLAT
-12,21,65,86,132,143,81,76,-117,-65,-19,-12,-161,-170,-113,-129,-124,-135,-140,-173,-103,-119,-129,-136,FLAT
-48,35,49,84,86,132,143,81,-12,-64,-62,-48,-129,-129,-81,-60,-173,-234,-175,-177,-136,-199,-202,-221,FLAT
38,108,20,128,84,86,132,143,-48,9,-35,38,-60,-55,-97,-10,-177,-120,-116,-22,-221,-225,-210,-139,FLAT
49,95,43,138,120,128,84,86,42,23,5,49,80,114,104,91,32,123,69,129,20,59,7,81,FLAT
31,45,35,80,138,120,128,84,49,23,81,31,91,46,86,80,129,137,185,122,81,146,150,160,FLAT
-20,24,72,96,80,138,120,128,31,17,1,-20,80,40,82,11,122,63,87,60,160,154,186,102,FLAT
-17,25,61,86,96,80,138,120,-20,-28,-18,-17,11,-11,-17,-37,60,12,64,-6,102,35,69,43,FLAT
-14,13,40,53,86,96,80,138,-17,-35,-2,-14,-37,-63,-20,-31,-6,-46,-19,-51,43,-23,62,-20,FLAT
33,40,21,61,53,86,96,80,-14,14,6,33,-31,-21,4,19,-51,-49,-14,2,-20,-32,-13,-18,FLAT
-43,35,67,102,61,53,86,96,33,3,-38,-43,19,17,-32,-10,2,-18,-34,-24,-18,-46,-52,-41,FLAT
-26,10,26,36,102,61,53,86,-43,-67,-1,-26,-10,-64,-39,-69,-24,-50,-33,-36,-41,-85,-35,-50,FLAT
26,51,31,82,36,102,61,53,-26,31,-15,26,-69,-36,-16,0,-36,-33,-54,-43,-50,-19,-48,-10,FLAT
18,21,10,31,82,36,102,61,26,-3,48,18,0,28,33,44,-43,-39,32,18,-10,-36,-6,-25,FLAT
16,16,20,36,31,82,36,102,18,26,21,16,44,23,69,34,18,54,54,60,-25,-13,53,34,FLAT
71,80,0,80,36,31,82,36,16,51,7,71,34,77,28,87,60,74,76,105,34,105,61,131,FLAT
-8,14,11,25,80,36,31,82,71,3,58,-8,87,54,65,63,105,80,86,79,131,77,134,97,FLAT
-4,11,21,32,25,80,36,31,-8,6,-1,-4,63,9,57,-12,79,60,64,59,97,86,85,75,FLAT
0,19,16,35,32,25,80,36,-4,-5,-8,0,-12,1,-9,-4,59,4,49,-12,75,55,56,59,FLAT
-8,8,18,26,35,32,25,80,0,-6,3,-8,-4,-11,-5,-8,-12,-5,-6,-12,59,-2,52,-20,FLAT
28,45,5,50,38,33,43,31,-21,0,-12,28,-1,9,-8,7,-25,-8,-15,27,-10,7,-12,3,FLAT
-7,10,11,21,50,38,33,43,28,-1,28,-7,7,-1,16,21,27,8,20,0,3,-9,13,20,FLAT
-17,0,20,20,21,50,38,33,-7,-8,-7,-17,21,-9,21,-24,0,-9,9,4,20,0,13,-17,FLAT
-29,1,33,34,20,21,50,38,-17,-16,-30,-29,-24,-24,-37,-46,4,-25,-9,-53,-17,-25,-21,-25,FLAT
-3,12,6,18,34,20,21,50,-29,-30,-14,-3,-46,-46,-44,-32,-53,-54,-51,-49,-25,-55,-23,-56,FLAT
-9,15,27,42,18,34,20,21,-3,12,-12,-9,-32,-18,-26,-12,-49,-34,-56,-41,-56,-42,-63,-58,FLAT
-9,0,27,27,42,18,34,20,-9,-9,6,-9,-12,3,-6,-18,-41,-27,-20,-21,-58,-43,-50,-50,FLAT
-33,31,41,72,27,42,18,34,-9,-19,-64,-33,-18,-28,-58,-42,-21,-16,-70,-51,-50,-46,-84,-54,FLAT
-25,10,25,35,72,27,42,18,-33,-41,-4,-25,-42,-60,-68,-58,-51,-69,-62,-67,-54,-57,-74,-76,FLAT
-38,18,133,151,35,72,27,42,-25,70,-46,-38,-58,29,-50,-63,-67,10,-114,-96,-76,1,-108,-105,FLAT
-52,56,69,125,151,35,72,27,-38,-116,-90,-52,-63,-46,-136,-90,-96,-87,-140,-115,-105,-106,-204,-148,FLAT
-19,7,51,58,125,151,35,72,-52,-37,30,-19,-90,-153,-60,-71,-115,-83,-106,-109,-148,-124,-110,-134,FLAT
97,97,12,109,126,58,125,151,60,44,61,97,41,118,67,157,-11,81,97,138,-49,-35,7,86,FLAT
54,58,6,64,109,126,58,125,97,48,93,54,157,92,154,151,138,166,160,211,86,129,190,192,FLAT
-132,6,143,149,64,109,126,58,54,5,-80,-132,151,53,13,-78,211,97,74,19,192,171,80,79,FLAT
45,64,17,81,149,64,109,126,-132,-81,-13,45,-78,-76,-93,-87,19,-28,0,-33,79,16,61,64,FLAT
68,83,17,100,147,81,149,64,-103,-24,23,68,-58,-35,-54,-35,-190,-116,-67,10,-136,-111,-147,-122,FLAT
-38,47,70,117,100,147,81,149,68,15,-2,-38,-35,-9,21,30,10,-20,-56,-73,-122,-101,-69,-28,FLAT
5,38,20,58,117,100,147,81,-38,-45,14,5,30,-30,12,-33,-73,-54,35,35,-28,-65,-42,-68,FLAT
47,82,28,110,58,117,100,147,5,55,3,47,-33,10,17,52,35,25,15,14,-68,1,38,82,FLAT
-139,40,149,189,185,110,58,117,-163,-156,-160,-139,-116,-181,-260,-302,-111,-126,-257,-255,-149,-171,-243,-250,FLAT
-1,43,16,59,189,185,110,58,-139,-134,-4,-1,-302,-290,-164,-140,-255,-315,-264,-303,-250,-260,-261,-256,FLAT
1,45,12,57,81,59,189,185,40,2,26,1,39,37,39,41,-100,-97,35,40,-263,-253,-125,-99,FLAT
40,52,5,57,57,81,59,189,1,33,33,40,41,35,59,41,40,70,72,81,-99,-64,68,80,FLAT
-45,4,79,83,57,57,81,59,40,29,3,-45,41,62,36,-5,81,64,62,-4,80,99,75,36,FLAT
-103,5,137,142,64,83,57,57,-37,-6,-84,-103,-82,-82,-141,-140,-42,-53,-138,-185,-41,-20,-105,-145,FLAT
15,39,6,45,142,64,83,57,-103,-116,-19,15,-140,-122,-103,-88,-185,-198,-160,-125,-145,-169,-157,-170,FLAT
35,74,1,75,131,45,142,64,100,23,79,35,115,130,100,135,12,14,81,150,-25,8,-3,47,FLAT
70,85,15,100,75,131,45,142,35,84,59,70,135,107,138,105,150,214,159,205,47,98,140,220,FLAT
53,88,26,114,100,75,131,45,70,64,50,53,105,148,109,123,205,171,188,158,220,278,209,258,FLAT
26,86,0,86,114,100,75,131,53,0,28,26,123,64,78,79,158,148,137,149,258,171,216,184,FLAT
28,50,53,103,86,114,100,75,26,81,64,28,79,81,92,54,149,145,142,107,184,229,201,177,FLAT
35,63,7,70,103,86,114,100,28,-11,22,35,54,70,86,63,107,70,114,89,177,134,164,142,FLAT
-6,30,39,69,70,103,86,114,35,26,27,-6,63,15,49,29,89,96,113,57,142,96,141,83,FLAT
48,49,38,87,69,70,103,86,-6,47,29,48,29,73,56,42,57,62,78,77,83,143,142,105,FLAT
139,140,53,193,87,69,70,103,48,154,48,139,42,201,77,187,77,227,104,181,105,216,126,216,FLAT
-72,12,86,98,193,87,69,70,139,-39,56,-72,187,115,104,67,181,162,133,115,216,188,160,109,FLAT
54,56,36,92,98,193,87,69,-72,4,10,54,67,-35,66,-18,115,119,114,121,109,166,143,169,FLAT
-23,16,76,92,155,92,98,193,-151,-100,-37,-23,-97,-134,-134,-174,-169,-130,-124,-120,-30,-169,-68,-192,FLAT
61,64,8,72,92,155,92,98,-23,-7,13,61,-174,-107,-24,38,-120,-141,-121,-113,-192,-137,-111,-59,FLAT
-76,2,82,84,72,92,155,92,61,-2,-14,-76,38,-9,-1,-15,-113,-109,-38,-38,-59,-143,-135,-189,FLAT
-2,20,20,40,84,72,92,155,-76,-64,-20,-2,-15,-66,-34,-78,-38,-73,-21,-17,-189,-173,-58,-40,FLAT
6,19,40,59,40,84,72,92,-2,26,7,6,-78,-38,-13,4,-17,-40,-27,-72,-40,-47,-14,-11,FLAT
87,87,2,89,35,59,40,84,16,70,16,87,22,65,35,103,20,91,42,109,-56,27,22,107,FLAT
18,30,9,39,89,35,59,40,87,25,75,18,103,95,91,105,109,90,110,121,107,116,117,127,FLAT
-45,0,55,55,39,89,35,59,18,1,-15,-45,105,26,60,-27,121,96,76,60,127,91,95,76,FLAT
-7,20,37,57,66,55,39,89,-46,-17,-8,-7,-91,-71,-73,-53,-73,-70,-88,-98,14,-45,-13,-80,FLAT
1,13,21,34,57,66,55,39,-7,-15,8,1,-53,-32,0,-6,-98,-86,-65,-52,-80,-85,-80,-97,FLAT
-9,13,12,25,52,37,43,71,33,-11,16,-9,57,23,35,24,64,35,53,48,13,13,59,55,FLAT
-23,4,25,29,25,52,37,43,-9,-10,-14,-23,24,-21,2,-32,48,13,21,1,55,25,39,25,FLAT
0,9,10,19,29,25,52,37,-23,-15,-5,0,-32,-25,-19,-23,1,-36,-3,-32,25,-2,16,1,FLAT
-13,1,14,15,19,29,25,52,0,-9,-5,-13,-23,-24,-10,-13,-32,-34,-24,-36,1,-45,-8,-45,FLAT
32,40,0,40,15,19,29,25,-13,18,-7,32,-13,9,-12,19,-36,-6,-17,19,-45,-16,-31,-4,FLAT
-12,2,37,39,40,15,19,29,32,25,26,-12,19,43,19,20,19,34,14,7,-4,19,9,7,FLAT
-23,5,24,29,39,40,15,19,-12,-36,-26,-23,20,-11,0,-35,7,7,-7,-3,7,-2,-12,-16,FLAT
42,46,8,54,29,39,40,15,-23,26,1,42,-35,-10,-25,19,-3,15,1,7,-16,33,-6,39,FLAT
21,24,22,46,54,29,39,40,42,35,43,21,19,61,44,63,7,25,18,40,39,50,44,28,FLAT
81,100,1,101,46,54,29,39,21,60,5,81,63,95,48,102,40,121,49,144,28,85,23,121,FLAT
-6,32,36,68,101,46,54,29,81,29,62,-6,102,89,67,75,144,124,110,96,121,150,111,138,FLAT
27,60,2,62,68,101,46,54,-6,-7,-1,27,75,22,61,21,96,82,66,102,138,117,109,123,FLAT
-110,1,131,132,59,62,68,101,-52,-36,-109,-110,-25,-33,-103,-162,-31,-40,-104,-135,50,-11,-42,-141,FLAT
1,61,26,87,132,59,62,68,-110,-104,-59,1,-162,-140,-168,-109,-135,-137,-162,-161,-141,-144,-163,-134,FLAT
-12,38,47,85,87,132,59,62,1,9,11,-12,-109,-95,-48,-11,-161,-131,-157,-121,-134,-128,-151,-173,FLAT
73,125,9,134,81,85,87,132,65,72,19,73,53,100,51,138,54,109,62,126,-56,5,3,127,FLAT
50,54,43,97,134,81,85,87,73,84,121,50,138,156,140,123,126,184,172,188,127,193,183,176,FLAT
-33,40,50,90,97,134,81,85,50,-26,-19,-33,123,58,102,17,188,130,121,90,176,158,153,155,FLAT
10,28,70,98,90,97,134,81,-33,30,22,10,17,4,3,-23,90,88,124,27,155,160,143,100,FLAT
-126,0,145,145,98,90,97,134,10,-51,-98,-126,-23,-21,-76,-116,27,-47,-95,-149,100,37,26,-99,FLAT
-1,24,21,45,145,98,90,97,-126,-125,-25,-1,-116,-176,-123,-127,-149,-146,-101,-117,-99,-172,-120,-150,FLAT
-25,1,52,53,81,45,145,98,54,11,39,-25,53,60,52,29,-73,-65,27,28,-63,-116,-71,-98,FLAT
-35,37,40,77,58,53,81,45,32,-14,-33,-35,7,-15,-39,-3,61,-4,0,-28,60,45,13,26,FLAT
91,91,5,96,77,58,53,81,-35,56,37,91,-3,42,4,56,-28,41,-2,88,26,52,37,63,FLAT
6,6,73,79,96,77,58,53,91,74,91,6,56,130,128,97,88,116,95,62,63,115,89,94,FLAT
16,21,19,40,79,96,77,58,6,-38,1,16,97,36,92,22,62,92,129,113,94,78,96,78,FLAT
-142,11,147,158,76,30,40,79,-20,-55,-137,-142,-36,-36,-164,-162,-20,-50,-168,-178,-14,-88,-167,-162,FLAT
-125,41,126,167,158,76,30,40,-142,-146,-155,-125,-162,-201,-292,-267,-178,-182,-319,-287,-162,-196,-323,-303,FLAT
-18,70,18,88,167,158,76,30,-125,-126,-47,-18,-267,-272,-202,-143,-287,-327,-339,-285,-303,-308,-366,-305,FLAT
90,100,75,175,297,88,167,158,281,150,272,90,263,428,341,371,138,302,294,353,-4,156,139,228,FLAT
-34,36,52,88,175,297,88,167,90,-57,30,-34,371,93,302,56,353,371,371,337,228,245,324,319,FLAT
-85,11,85,96,88,175,297,88,-34,-52,-60,-85,56,-109,-30,-119,337,41,242,-29,319,319,311,252,FLAT
105,105,38,143,96,88,175,297,-85,58,11,105,-119,6,-49,20,-29,-51,-19,-14,252,99,253,76,FLAT
-38,2,94,96,143,96,88,175,105,18,65,-38,20,76,76,67,-14,24,16,-18,76,-33,46,-52,FLAT
142,153,32,185,96,143,96,88,-38,80,-9,142,67,98,56,104,-18,156,67,209,-52,104,7,124,FLAT
23,74,6,80,141,77,185,96,-46,-88,-27,23,-94,-74,-77,-23,48,-97,8,-71,10,-17,-1,71,FLAT
-95,9,107,116,80,141,77,185,23,6,-30,-95,-23,-82,-57,-72,-71,-68,-107,-118,71,-91,-22,-166,FLAT
8,52,11,63,116,80,141,77,-95,-88,-35,8,-72,-82,-65,-87,-118,-170,-92,-64,-166,-156,-142,-110,FLAT
-30,4,41,45,63,116,80,141,8,0,18,-30,-87,-88,-17,-22,-64,-82,-47,-117,-110,-170,-74,-94,FLAT
17,24,42,66,45,63,116,80,-30,18,-3,17,-22,18,15,-13,-117,-70,-20,-5,-94,-64,-50,-100,FLAT
3,16,23,39,66,45,63,116,17,-16,11,3,-13,2,8,20,-5,2,26,-10,-100,-86,-9,-2,FLAT
-40,23,46,69,39,66,45,63,3,-17,-47,-40,20,-33,-36,-37,-10,-15,-39,-20,-2,-15,-21,-50,FLAT
-7,9,27,36,69,39,66,45,-40,-26,7,-7,-37,-43,-40,-47,-20,-59,-29,-44,-50,-41,-32,-27,FLAT
21,38,5,43,36,69,39,66,-7,-1,-8,21,-47,-27,-1,14,-44,-44,-48,-26,-27,-60,-37,-23,FLAT
14,37,1,38,43,36,69,39,21,10,15,14,14,9,7,35,-26,-17,14,28,-23,-34,-33,-12,FLAT
-2,7,22,29,38,43,36,69,14,19,28,-2,35,29,43,12,28,28,35,33,-12,2,42,26,FLAT
-36,3,51,54,29,38,43,36,-2,-7,-32,-36,12,12,-4,-38,33,22,11,-24,26,21,3,-3,FLAT
56,66,3,69,54,29,38,43,-36,8,-7,56,-38,1,-39,20,-24,20,-11,18,-3,30,4,32,FLAT
2,10,3,13,29,28,23,26,-11,-22,-6,2,-18,-21,-6,-9,-12,-21,-11,-16,-20,-22,-9,-10,FLAT
-14,18,14,32,13,29,28,23,2,-3,-22,-14,-9,-25,-28,-12,-16,-24,-28,-23,-10,-24,-33,-30,FLAT
-21,6,32,38,32,13,29,28,-14,-3,-9,-21,-12,-6,-31,-35,-23,-28,-37,-33,-30,-27,-37,-44,FLAT
-6,13,8,21,38,32,13,29,-21,-30,-13,-6,-35,-33,-22,-27,-33,-36,-44,-41,-44,-58,-50,-39,FLAT
4,11,3,14,21,38,32,13,-6,-1,6,4,-27,-31,-7,-2,-41,-34,-16,-23,-39,-37,-38,-37,FLAT
-21,3,26,29,14,21,38,32,4,2,-13,-21,-2,1,-7,-17,-23,-29,-20,-23,-37,-32,-29,-44,FLAT
4,7,20,27,29,14,21,38,-21,-2,0,4,-17,0,-13,-17,-23,-1,-7,-13,-44,-31,-20,-19,FLAT
-24,9,26,35,27,29,14,21,4,-18,-26,-24,-17,-20,-26,-20,-13,-18,-39,-41,-19,-19,-33,-37,FLAT
44,49,5,54,35,27,29,14,-24,23,4,44,-20,5,-22,20,-41,3,-22,24,-37,5,-35,3,FLAT
14,48,10,58,54,35,27,29,44,19,15,14,20,42,19,58,24,24,-7,34,3,22,-7,38,FLAT
-43,40,45,85,117,58,54,35,-80,-95,-63,-43,-66,-88,-115,-123,-22,-69,-100,-109,-46,-46,-96,-65,FLAT
-81,39,91,130,85,117,58,54,-43,-35,-80,-81,-123,-130,-143,-124,-109,-123,-195,-204,-65,-104,-180,-190,FLAT
15,20,30,50,130,85,117,58,-81,-46,34,15,-124,-81,-46,-66,-204,-176,-109,-109,-190,-169,-161,-189,FLAT
-29,2,99,101,66,50,130,85,30,35,0,-29,45,70,19,1,-36,24,53,16,-79,-11,-27,-65,FLAT
130,178,14,192,101,66,50,130,-29,45,-46,130,1,80,-46,101,16,115,-27,131,-65,69,7,146,FLAT
43,50,115,165,192,101,66,50,130,144,171,43,101,189,125,173,131,224,125,144,146,259,144,174,FLAT
-41,4,93,97,165,192,101,66,43,-63,5,-41,173,81,176,2,144,126,130,132,174,161,130,103,FLAT
42,83,0,83,97,165,192,101,-41,-51,-37,42,2,-114,-32,1,132,30,139,44,103,75,93,174,FLAT
-10,70,16,86,83,97,165,192,42,6,3,-10,1,-45,-34,32,44,-108,-29,-9,174,36,142,34,FLAT
-67,6,91,97,86,83,97,165,-10,8,-3,-67,32,14,0,-77,-9,-37,-37,-35,34,-100,-32,-76,FLAT
50,52,38,90,97,86,83,97,-67,-3,4,50,-77,5,1,-17,-35,11,4,-27,-76,-40,-33,15,FLAT
-14,51,26,77,90,97,86,83,50,-26,-13,-14,-17,-29,-9,36,-27,-21,-12,-31,15,-15,-9,-41,FLAT
-19,25,21,46,77,90,97,86,-14,-24,7,-19,36,-50,-6,-33,-31,-53,-2,17,-41,-45,-5,-50,FLAT
79,136,9,145,46,77,90,97,-19,67,-32,79,-33,43,-25,60,17,17,-38,46,-50,14,-34,96,FLAT
10,35,5,40,145,46,77,90,79,6,111,10,60,73,79,89,46,49,86,70,96,23,73,56,FLAT
56,60,20,80,40,145,46,77,10,71,31,56,89,77,142,66,70,144,110,145,56,120,117,126,FLAT
-41,20,52,72,80,40,145,46,56,-9,-1,-41,66,62,30,15,145,68,141,25,126,135,109,104,FLAT
65,90,1,91,72,80,40,145,-41,14,-5,65,15,5,-6,24,25,76,25,80,104,82,136,90,FLAT
14,35,79,114,91,72,80,40,65,92,69,14,24,106,64,79,80,97,63,38,90,168,94,94,FLAT
70,72,6,78,114,91,72,80,14,-3,33,70,79,89,102,84,38,103,97,149,94,94,96,108,FLAT
14,59,45,104,78,114,91,72,70,53,27,14,84,50,60,84,149,142,129,98,108,156,124,163,FLAT
-18,21,27,48,104,78,114,91,14,-36,20,-18,84,17,47,-4,98,14,80,66,163,106,149,80,FLAT
13,76,11,87,48,104,78,114,-18,-3,-42,13,-4,-39,-22,-5,66,14,5,9,80,11,38,79,FLAT
25,32,68,100,87,48,104,78,13,82,69,25,-5,79,27,38,9,43,47,20,79,96,74,34,FLAT
45,98,9,107,100,87,48,104,25,-14,-21,45,38,68,48,70,20,65,6,83,34,29,26,65,FLAT
-5,24,64,88,107,100,87,48,45,50,69,-5,70,36,48,40,83,118,117,65,65,115,75,78,FLAT
63,74,28,102,94,88,107,100,-43,11,3,63,-48,-16,-30,20,-3,34,39,15,22,20,18,60,FLAT
-338,23,339,362,102,94,88,107,63,-27,-287,-338,20,-16,-284,-275,15,-43,-317,-318,60,7,-248,-323,FLAT
16,148,26,174,362,102,94,88,-338,-297,-109,16,-275,-324,-396,-322,-318,-313,-393,-259,-323,-340,-426,-302,FLAT
170,202,46,248,174,362,102,94,16,190,116,170,-322,-107,7,186,-259,-134,-280,-152,-302,-123,-277,-89,FLAT
-135,3,135,138,248,174,362,102,170,-46,64,-135,186,144,180,35,-152,-153,71,51,-89,-180,-216,-287,FLAT
113,116,73,189,138,248,174,362,-135,51,0,113,35,5,64,-22,51,195,180,148,-287,-102,71,164,FLAT
27,38,23,61,189,138,248,174,113,-23,105,27,-22,28,105,140,148,-18,169,5,164,172,285,175,FLAT
16,33,34,67,61,189,138,248,27,27,21,16,140,4,126,43,5,55,126,156,175,9,190,21,FLAT
-19,43,41,84,67,61,189,138,16,-12,-29,-19,43,15,-8,-3,156,-8,97,24,21,43,97,137,FLAT
-24,10,47,57,84,67,61,189,-19,-18,9,-24,-3,-30,-20,-43,24,-3,1,-27,137,-26,106,0,FLAT
36,65,15,80,57,84,67,61,-24,4,-19,36,-43,-14,-10,12,-27,-26,-39,-7,0,1,-18,9,FLAT
-4,15,27,42,80,57,84,67,36,8,46,-4,12,12,27,32,-7,-6,36,8,9,-18,7,-11,FLAT
12,53,11,64,42,80,57,84,-4,-4,-26,12,32,4,20,8,8,8,1,44,-11,-10,10,20,FLAT
27,31,7,38,64,42,80,57,12,23,49,27,8,19,23,39,44,27,69,35,20,31,50,71,FLAT
9,29,9,38,38,64,42,80,27,11,11,9,39,34,60,36,35,30,34,48,71,38,80,44,FLAT
-65,14,65,79,38,38,64,42,9,-9,-50,-65,36,2,-39,-56,48,25,10,-29,44,21,-16,-17,FLAT
7,13,23,36,79,38,38,64,-65,-35,8,7,-56,-44,-42,-58,-29,-33,-31,-49,-17,-10,18,-22,FLAT
64,67,3,70,36,79,38,38,7,44,10,64,-58,9,18,71,-49,0,-32,6,-22,11,-21,15,FLAT
6,19,7,26,34,30,26,79,-15,-9,-1,6,-6,-22,-18,-9,2,0,0,0,-59,-58,-5,8,FLAT
-13,7,14,21,26,34,30,26,6,-6,-1,-13,-9,-15,-2,-7,0,-28,-19,-22,8,-6,-1,-13,FLAT
13,17,2,19,21,26,34,30,-13,1,3,13,-7,-5,2,0,-22,-14,1,6,-13,-27,-16,-9,FLAT
-1,11,10,21,19,21,26,34,13,7,5,-1,0,8,8,12,6,2,7,-1,-9,-7,6,5,FLAT
-12,12,15,27,21,19,21,26,-1,-7,-13,-12,12,0,-8,-13,-1,1,-5,0,5,-5,-6,-13,FLAT
-34,9,42,51,27,21,19,21,-12,-7,-31,-34,-13,-14,-44,-46,0,-7,-39,-47,-13,-6,-36,-34,FLAT
-21,7,24,31,51,27,21,19,-34,-39,-19,-21,-46,-46,-50,-55,-47,-53,-63,-67,-34,-46,-58,-68,FLAT
-2,7,28,35,31,51,27,21,-21,2,-2,-2,-55,-37,-21,-23,-67,-44,-52,-57,-68,-51,-65,-69,FLAT
35,57,3,60,35,31,51,27,-2,10,-15,35,-23,12,-17,33,-57,-27,-36,12,-69,-34,-67,-22,FLAT
38,67,12,79,60,35,31,51,35,47,28,38,33,57,13,73,12,59,11,71,-22,20,-8,50,FLAT
39,60,6,66,79,60,35,31,38,33,46,39,73,80,74,77,71,90,59,112,50,92,57,110,FLAT
-79,24,80,104,66,79,60,35,39,-5,-43,-79,77,28,3,-40,112,75,31,-2,110,85,16,33,FLAT
-32,18,44,62,104,66,79,60,-79,-68,-26,-32,-40,-73,-69,-111,-2,-40,-23,-72,33,7,5,-34,FLAT
-18,71,34,105,62,104,66,79,-32,-28,-71,-18,-111,-96,-97,-50,-72,-101,-140,-129,-34,-68,-94,-90,FLAT
71,94,13,107,69,73,105,62,13,44,6,71,68,80,46,84,50,118,116,139,18,90,45,121,FLAT
57,64,18,82,107,69,73,105,71,62,87,57,84,106,93,128,139,142,133,141,121,180,203,196,FLAT
-74,1,80,81,82,107,69,73,57,-12,-11,-74,128,50,76,-17,141,94,82,54,196,130,122,67,FLAT
42,57,32,89,81,82,107,69,-74,-6,-14,42,-17,-18,-25,-32,54,44,62,25,67,88,68,96,FLAT
192,198,10,208,89,81,82,107,42,170,51,192,-32,164,37,234,25,152,26,160,96,214,113,217,FLAT
93,159,8,167,208,89,81,82,192,91,132,93,234,261,183,285,160,255,169,327,217,243,158,253,FLAT
11,48,14,62,167,208,89,81,93,17,122,11,285,108,254,104,327,278,305,296,253,272,291,338,FLAT
1,31,13,44,62,167,208,89,11,0,18,1,104,17,140,12,296,108,272,105,338,278,323,297,FLAT
-189,9,193,202,44,62,167,208,1,-9,-167,-189,12,-9,-149,-188,105,8,-27,-177,297,99,105,-84,FLAT
55,67,25,92,202,44,62,167,-189,-113,-3,55,-188,-122,-170,-134,-177,-122,-152,-133,-84,-105,-30,-122,FLAT
43,46,20,66,92,202,44,62,55,38,64,43,-134,-75,61,98,-133,-84,-106,-91,-122,-84,-88,-90,FLAT
-6,37,19,56,66,92,202,44,43,-7,3,-6,98,31,67,37,-91,-82,64,92,-90,-91,-103,-97,FLAT
71,71,6,77,56,66,92,202,-6,58,37,71,37,51,40,65,92,89,104,108,-97,-24,101,163,FLAT
-81,21,91,112,77,56,66,92,71,4,-31,-81,65,62,6,-10,108,55,9,-16,163,93,73,27,FLAT
-55,18,70,88,112,77,56,66,-81,-76,-52,-55,-10,-72,-83,-136,-16,-14,-46,-65,27,-21,-43,-71,FLAT
-8,2,63,65,88,112,77,56,-55,-15,8,-8,-136,-91,-44,-63,-65,-87,-75,-144,-71,-29,-38,-73,FLAT
2,34,26,60,65,88,112,77,-8,-35,-30,2,-63,-50,-22,-6,-144,-126,-74,-61,-73,-122,-105,-142,FLAT
-17,1,52,53,60,65,88,112,2,9,16,-17,-6,-26,-14,-15,-61,-41,-6,-23,-142,-117,-58,-78,FLAT
82,95,0,95,53,60,65,88,-17,30,-12,82,-15,39,4,65,-23,4,-26,67,-78,-11,-18,59,FLAT
28,61,6,67,95,53,60,65,82,34,62,28,65,64,50,110,67,73,66,93,59,38,36,95,FLAT
114,135,20,155,67,95,53,60,28,128,40,114,110,162,102,142,93,192,90,224,95,201,106,207,FLAT
42,75,42,117,155,67,95,53,114,64,102,42,142,192,142,156,224,226,204,184,207,256,192,266,FLAT
-104,17,108,125,117,155,67,95,42,-38,-46,-104,156,26,56,-62,184,154,96,52,266,188,158,80,FLAT
15,55,21,76,125,117,155,67,-104,-72,-23,15,-62,-110,-69,-89,52,-46,33,-47,80,82,73,67,FLAT
55,105,17,122,76,125,117,155,15,51,5,55,-89,-21,-18,70,-47,-59,-64,-34,67,5,38,8,FLAT
22,48,11,59,122,76,125,117,55,16,79,22,70,67,84,77,-34,-5,61,92,8,-43,15,-12,FLAT
-47,6,78,84,59,122,76,125,22,20,-5,-47,77,36,74,-25,92,87,79,30,-12,15,56,45,FLAT
123,131,32,163,84,59,122,76,-47,77,-2,123,-25,97,-7,76,30,113,72,98,45,164,77,153,FLAT
-44,27,59,86,163,84,59,122,123,-17,60,-44,76,60,58,79,98,80,53,32,153,96,132,54,FLAT
-27,31,38,69,86,163,84,59,-44,-48,-31,-27,79,-65,29,-71,32,12,27,52,54,32,22,5,FLAT
-55,0,113,113,69,86,163,84,-27,20,-24,-55,-71,-28,-55,-82,52,-45,5,-126,5,32,3,-3,FLAT
19,25,25,50,113,69,86,163,-55,-69,-6,19,-82,-49,-30,-36,-126,-97,-61,-63,-3,-114,-1,-107,FLAT
-2,9,38,47,60,49,50,113,46,32,45,-2,74,67,69,44,93,85,88,72,38,16,82,91,FLAT
18,22,16,38,47,60,49,50,-2,-4,5,18,44,28,50,16,72,63,74,62,91,81,93,90,FLAT
18,28,4,32,38,47,60,49,18,6,12,18,16,2,17,36,62,34,62,34,90,69,86,80,FLAT
24,26,16,42,32,38,47,60,18,36,26,24,36,42,38,42,34,38,43,60,80,70,88,58,FLAT
30,43,11,54,42,32,38,47,24,25,13,30,42,61,39,54,60,67,51,72,58,63,56,90,FLAT
59,60,8,68,54,42,32,38,30,56,42,59,54,81,55,89,72,117,81,113,90,123,93,131,FLAT
-9,27,43,70,68,54,42,32,59,26,24,-9,89,82,66,50,113,107,79,80,131,143,105,104,FLAT
-15,9,16,25,27,26,55,31,6,-11,-9,-15,-18,-19,-18,-9,5,-25,5,-33,13,-6,0,-10,FLAT
27,32,2,34,25,27,26,55,-15,13,4,27,-9,2,-5,12,-33,-6,-14,18,-10,-12,9,-6,FLAT
17,18,16,34,34,25,27,26,27,31,31,17,12,44,35,44,18,33,26,29,-6,25,17,35,FLAT
-42,2,42,44,34,34,25,27,17,-16,-26,-42,44,15,5,-25,29,28,9,2,35,17,0,-13,FLAT
-19,3,23,26,44,34,34,25,-42,-38,-20,-19,-25,-54,-46,-61,2,-23,-15,-44,-13,-10,-11,-17,FLAT
11,40,6,46,26,44,34,34,-19,-6,-26,11,-61,-44,-46,-8,-44,-60,-72,-50,-17,-29,-41,-33,FLAT
-61,2,82,84,46,26,44,34,11,15,-23,-61,-8,9,-49,-50,-50,-29,-69,-69,-33,-45,-95,-111,FLAT
42,54,1,55,84,46,26,44,-61,-39,-10,42,-50,-24,-33,-19,-69,-30,-59,-8,-111,-68,-79,-27,FLAT
-13,5,39,44,55,84,46,26,42,25,36,-13,-19,-14,26,29,-8,1,3,-32,-27,-5,-23,-21,FLAT
52,58,22,80,44,55,84,46,-13,35,-1,52,29,60,35,39,-32,21,25,81,-21,36,2,20,FLAT
-6,64,9,73,80,44,55,84,52,-19,-12,-6,39,16,-13,46,81,41,23,33,20,2,13,75,FLAT
-25,37,37,74,73,80,44,55,-6,3,2,-25,46,-16,-10,-31,33,19,-11,21,75,44,25,8,FLAT
6,56,35,91,74,73,80,44,-25,4,-13,6,-31,7,-11,-19,21,-12,-23,-25,8,23,-24,27,FLAT
-161,53,161,214,91,74,73,80,6,-35,-158,-161,-19,-31,-171,-155,-25,-28,-169,-180,27,-47,-181,-186,FLAT
-87,9,146,155,214,91,74,73,-161,-102,-43,-87,-155,-137,-201,-248,-180,-133,-214,-242,-186,-130,-212,-267,FLAT
5,29,43,72,155,214,91,74,-87,-98,-15,5,-248,-200,-58,-82,-242,-235,-216,-243,-267,-231,-229,-237,FLAT
52,58,15,73,72,155,214,91,5,24,23,52,-82,-74,8,57,-243,-176,-35,-30,-237,-211,-193,-191,FLAT
-35,37,45,82,73,72,155,214,52,-5,-14,-35,57,19,9,17,-30,-79,-6,22,-191,-181,-49,-65,FLAT
-22,7,48,55,82,73,72,155,-35,-19,8,-22,17,-24,-6,-57,22,0,17,-5,-65,-98,2,0,FLAT
104,119,15,134,55,82,73,72,-22,71,-8,104,-57,52,0,82,-5,47,-14,47,0,71,9,99,FLAT
24,49,14,63,134,55,82,73,104,23,94,24,82,94,86,128,47,75,94,106,99,70,80,71,FLAT
15,44,28,72,63,134,55,82,24,29,20,15,128,52,114,39,106,123,106,143,71,104,114,121,FLAT
-6,26,26,52,81,72,63,134,-38,-40,-11,-6,-23,-46,-26,-44,1,-17,-6,-29,105,6,88,-5,FLAT
-65,3,81,84,52,81,72,63,-6,-10,-42,-65,-44,-50,-53,-71,-29,-56,-68,-109,-5,-27,-48,-94,FLAT
2,9,53,62,84,52,81,72,-65,-26,-4,2,-71,-36,-46,-63,-109,-76,-57,-69,-94,-82,-72,-107,FLAT
-38,2,46,48,62,84,52,81,2,-45,-31,-38,-63,-71,-35,-36,-69,-81,-77,-101,-107,-121,-88,-107,FLAT
15,23,38,61,48,62,84,52,-38,7,-6,15,-36,-38,-37,-23,-101,-64,-41,-21,-107,-74,-83,-86,FLAT
-77,10,84,94,61,48,62,84,15,-31,-64,-77,-23,-24,-70,-62,-21,-69,-101,-100,-86,-95,-105,-98,FLAT
0,46,32,78,94,61,48,62,-77,-52,-36,0,-62,-83,-100,-77,-100,-76,-106,-62,-98,-121,-137,-100,FLAT
-21,12,54,66,78,94,61,48,0,1,13,-21,-77,-51,-23,-21,-62,-82,-87,-98,-100,-75,-93,-83,FLAT
-37,52,65,117,66,78,94,61,-21,-26,-77,-37,-21,-25,-64,-58,-98,-77,-100,-58,-83,-108,-164,-135,FLAT
21,34,13,47,117,66,78,94,-37,-31,39,21,-58,-57,-38,-16,-58,-56,-25,-37,-135,-108,-61,-37,FLAT
65,72,20,92,47,117,66,78,21,72,27,65,-16,41,66,86,-37,15,-11,49,-37,16,2,28,FLAT
30,43,17,60,92,47,117,66,65,27,59,30,86,99,86,95,49,68,125,116,28,42,48,79,FLAT
-44,16,73,89,60,92,47,117,30,12,-17,-44,95,39,42,-14,116,111,69,51,79,80,108,72,FLAT
-92,14,107,121,89,89,60,92,-47,-42,-74,-92,-91,-105,-137,-139,-61,-93,-154,-183,4,-66,-95,-153,FLAT
39,49,16,65,121,89,89,60,-92,-52,4,39,-139,-94,-70,-53,-183,-157,-133,-100,-153,-145,-150,-144,FLAT
-120,9,149,158,65,121,89,89,39,13,-80,-120,-53,-39,-76,-81,-100,-81,-150,-173,-144,-144,-213,-220,FLAT
-7,49,34,83,158,65,121,89,-120,-122,-47,-7,-81,-109,-127,-127,-173,-161,-123,-88,-220,-203,-197,-180,FLAT
-157,24,202,226,83,158,65,121,-7,11,-132,-157,-127,-111,-179,-164,-88,-98,-259,-284,-180,-150,-255,-245,FLAT
9,62,11,73,226,83,158,65,-157,-182,-29,9,-164,-171,-161,-148,-284,-293,-208,-155,-245,-280,-288,-275,FLAT
-8,23,60,83,73,226,83,158,9,41,31,-8,-148,-141,2,1,-155,-130,-130,-156,-275,-252,-177,-163,FLAT
-69,17,113,130,83,73,226,83,-8,-16,-63,-69,1,25,-32,-77,-156,-157,-61,-68,-163,-146,-193,-225,FLAT
103,128,0,128,130,83,73,226,-69,-10,-8,103,-77,-26,-71,34,-68,15,-40,26,-225,-167,-69,35,FLAT
-101,43,102,145,57,128,130,83,-31,-35,-123,-101,72,-30,-47,-132,3,-40,-55,-29,-5,-56,-118,-98,FLAT
-52,1,87,88,145,57,128,130,-101,-67,-10,-52,-132,-102,-133,-153,-29,-97,-57,-184,-98,-107,-65,-81,FLAT
14,47,23,70,88,145,57,128,-52,-50,-32,14,-153,-117,-42,-38,-184,-152,-165,-139,-81,-147,-89,-170,FLAT
-9,26,42,68,70,88,145,57,14,10,12,-9,-38,-40,-20,5,-139,-107,-30,-47,-170,-142,-153,-148,FLAT
-11,24,12,36,68,70,88,145,-9,-41,-9,-11,5,-31,3,-20,-47,-81,-29,-6,-148,-148,-39,-58,FLAT
0,15,38,53,36,68,70,88,-11,26,9,0,-20,-15,0,-11,-6,-5,12,-20,-58,-55,-20,-6,FLAT
-23,0,71,71,53,36,68,70,0,10,-8,-23,-11,36,1,-23,-20,-5,-8,-34,-6,5,4,-43,FLAT
24,34,16,50,71,53,36,68,-23,-31,-10,24,-23,-21,-18,1,-34,5,-9,1,-43,-36,-18,-10,FLAT
-8,26,14,40,50,71,53,36,24,-10,0,-8,1,-41,-10,16,1,-31,-18,-7,-10,-5,-9,-7,FLAT
13,45,17,62,40,50,71,53,-8,16,-6,13,16,6,-6,5,-7,-25,-16,29,-7,-15,-24,6,FLAT
-19,13,19,32,35,25,40,37,24,-2,1,-19,24,4,-3,5,-1,-14,-6,5,15,-14,-9,-20,FLAT
-9,5,15,20,32,35,25,40,-19,-13,-1,-9,5,-15,0,-28,5,-9,-4,-4,-20,-27,-7,-4,FLAT
1,23,3,26,20,32,35,25,-9,-11,-17,1,-28,-24,-18,-8,-4,-26,-17,-27,-4,-20,-21,-3,FLAT
3,18,12,30,36,51,26,20,27,9,15,3,67,32,53,30,68,79,75,70,59,68,58,71,FLAT
14,19,4,23,30,36,51,26,3,6,13,14,30,15,28,17,70,38,66,44,71,85,88,84,FLAT
60,78,5,83,23,30,36,51,14,61,1,60,17,67,14,74,44,76,29,77,84,99,67,104,FLAT
-1,28,19,47,83,23,30,36,60,13,49,-1,74,74,50,59,77,80,63,73,104,89,78,76,FLAT
2,43,19,62,47,83,23,30,-1,2,-13,2,59,15,36,1,73,76,37,61,76,82,50,75,FLAT
54,64,0,64,62,47,83,23,2,35,33,54,1,37,20,56,61,50,69,55,75,111,70,115,FLAT
79,84,11,95,64,62,47,83,54,90,59,79,56,125,92,133,55,127,79,135,115,140,128,134,FLAT
45,57,49,106,95,64,62,47,79,83,72,45,133,173,131,124,135,208,164,178,134,210,151,180,FLAT
31,58,16,74,106,95,64,62,45,-2,30,31,124,81,102,76,178,171,161,155,180,206,194,209,FLAT
141,145,20,165,74,106,95,64,31,145,54,141,76,143,84,172,155,226,156,217,209,316,215,296,FLAT
-66,9,81,90,165,74,106,95,141,-5,70,-66,172,140,124,75,217,138,154,106,296,221,226,151,FLAT
20,71,2,73,90,165,74,106,-66,-59,-42,20,75,-64,28,-46,106,81,82,95,151,79,112,126,FLAT
-13,20,32,52,73,90,165,74,20,17,38,-13,-46,-42,-4,7,95,-47,66,-59,126,98,120,82,FLAT
183,184,21,205,52,73,90,165,-13,172,19,183,7,189,57,170,-59,130,15,190,82,125,85,124,FLAT
-49,2,86,88,205,52,73,90,183,16,133,-49,170,188,152,134,190,205,190,121,124,146,148,141,FLAT
104,109,14,123,88,205,52,73,-49,32,-3,104,134,48,130,55,121,220,149,238,141,237,187,225,FLAT
62,69,59,128,123,88,205,52,104,107,102,62,55,139,99,166,238,155,232,117,225,327,251,300,FLAT
-7,32,71,103,128,123,88,205,62,5,30,-7,166,112,132,55,117,144,129,159,300,160,262,110,FLAT
-25,17,51,68,103,128,123,88,-7,-45,-10,-25,55,-40,20,-32,159,67,122,30,110,99,119,134,FLAT
-37,42,53,95,68,103,128,123,-25,-35,-62,-37,-32,-80,-72,-62,30,-75,-42,-69,134,32,60,-7,FLAT
19,19,77,96,95,68,103,128,-37,43,42,19,-62,8,-20,-18,-69,-37,-30,-43,-7,-32,0,-50,FLAT
86,86,38,124,100,96,95,68,54,122,98,86,73,101,73,140,36,144,115,159,11,109,53,122,FLAT
-119,10,175,185,124,100,96,95,86,18,-43,-119,140,140,55,-33,159,119,30,21,122,162,72,40,FLAT
-134,5,167,172,185,124,100,96,-119,-142,-129,-134,-33,-124,-172,-253,21,-2,-74,-167,40,-23,-99,-113,FLAT
147,148,11,159,172,185,124,100,-134,-9,4,147,-253,-151,-125,13,-167,-133,-168,-106,-113,-11,-70,-20,FLAT
95,118,14,132,159,172,185,124,147,98,125,95,13,89,129,242,-106,-53,0,108,-20,-35,-43,-11,FLAT
-98,29,123,152,132,159,172,185,95,11,-9,-98,242,109,116,-3,108,100,120,144,-11,-42,-9,10,FLAT
-90,4,113,117,152,132,159,172,-98,-100,-65,-90,-3,-89,-74,-188,144,9,51,-93,10,0,55,54,FLAT
1,129,35,164,148,117,152,132,130,34,18,1,40,53,6,131,-58,-47,-59,41,37,-36,-68,-57,FLAT
36,41,38,79,164,148,117,152,1,39,124,36,131,73,142,37,41,92,130,167,-57,-8,65,77,FLAT
-20,36,27,63,79,164,148,117,36,-31,-15,-20,37,8,109,16,167,42,127,17,77,61,115,147,FLAT
358,369,80,449,63,79,164,148,-20,411,25,358,16,380,10,338,17,419,134,374,147,453,152,375,FLAT
-71,26,102,128,449,63,79,164,358,-49,272,-71,338,362,297,287,374,331,282,267,375,370,406,303,FLAT
46,60,82,142,128,449,63,79,-71,26,12,46,287,-23,284,-25,267,388,309,333,303,357,294,313,FLAT
-65,55,65,120,139,142,128,449,-123,-131,-112,-65,-77,-205,-183,-188,-148,-179,-171,-142,210,-228,101,-213,FLAT
-123,3,161,164,120,139,142,128,-65,-27,-71,-123,-188,-158,-183,-188,-142,-232,-254,-311,-213,-206,-242,-265,FLAT
-108,15,124,139,164,120,139,142,-123,-145,-120,-108,-188,-172,-191,-231,-311,-303,-303,-296,-265,-377,-374,-419,FLAT
29,64,83,147,139,164,120,139,-108,-12,-20,29,-231,-157,-140,-79,-296,-184,-211,-202,-419,-315,-323,-267,FLAT
17,116,10,126,147,139,164,120,29,-56,-35,17,-79,-68,-55,46,-202,-213,-175,-62,-267,-240,-246,-185,FLAT
64,90,7,97,126,147,139,164,17,61,90,64,46,5,55,81,-62,-7,35,110,-185,-152,-85,2,FLAT
-33,28,59,87,97,126,147,139,64,19,29,-33,81,80,119,31,110,24,84,48,2,12,64,77,FLAT
-23,25,42,67,87,97,126,147,-33,-40,-20,-23,31,-21,9,-56,48,40,99,8,77,-16,64,25,FLAT
-144,9,159,168,67,87,97,126,-23,-27,-128,-144,-56,-67,-148,-167,8,-48,-119,-200,25,13,-29,-136,FLAT
3,16,31,47,168,67,87,97,-144,-125,-4,3,-167,-152,-132,-141,-200,-192,-152,-164,-136,-173,-123,-197,FLAT
65,78,7,85,47,168,67,87,3,41,3,65,-141,-84,-1,68,-164,-111,-129,-76,-197,-151,-149,-99,FLAT
-57,4,68,72,85,47,168,67,65,4,17,-57,68,45,20,8,-76,-80,16,11,-99,-107,-112,-133,FLAT
41,47,20,67,72,85,47,168,-57,-7,-2,41,8,-3,15,-16,11,38,18,49,-133,-87,14,52,FLAT
-24,16,38,54,67,72,85,47,41,-6,7,-24,-16,-13,5,17,49,-9,22,-40,52,32,25,25,FLAT
4,26,14,40,54,67,72,85,-24,-20,-6,4,17,-26,1,-20,-40,-33,-1,21,25,-29,16,-36,FLAT
-40,0,43,43,27,45,25,18,0,-22,-38,-40,-33,-40,-38,-40,-32,-37,-55,-73,-25,-37,-62,-72,FLAT
26,26,5,31,43,27,45,25,-40,-12,0,26,-40,-34,-38,-14,-73,-52,-38,-14,-72,-49,-55,-47,FLAT
45,45,12,57,31,43,27,45,26,52,26,45,-14,40,26,71,-14,18,-12,31,-47,0,-12,31,FLAT
1,12,19,31,57,31,43,27,45,8,34,1,71,60,60,46,31,48,60,72,31,26,22,32,FLAT
-23,1,38,39,31,57,31,43,1,-4,-12,-23,46,4,22,-22,72,56,48,23,32,44,48,49,FLAT
37,44,7,51,39,31,57,31,-23,6,-6,37,-22,2,-18,14,23,10,16,15,49,62,42,60,FLAT
20,41,1,42,51,39,31,57,37,14,23,20,14,20,17,57,15,16,5,34,60,24,39,35,FLAT
36,38,4,42,42,51,39,31,20,39,39,36,57,53,62,56,34,59,56,93,35,55,44,70,FLAT
-3,35,38,73,42,42,51,39,36,31,0,-3,56,70,39,33,93,84,62,53,70,90,56,90,FLAT
-5,17,37,54,43,73,42,42,-39,-9,-20,-5,-42,-45,-26,-44,-6,-14,-26,-47,14,25,13,-11,FLAT
3,67,29,96,54,43,73,42,-5,-5,-47,3,-44,-14,-67,-2,-47,-50,-73,-41,-11,-19,-73,-44,FLAT
4,47,57,104,96,54,43,73,3,32,24,4,-2,27,-23,7,-41,18,-43,2,-44,-18,-49,-37,FLAT
-83,42,91,133,104,96,54,43,4,-49,-78,-83,7,-17,-54,-79,2,-22,-101,-76,-37,-31,-121,-81,FLAT
-66,13,77,90,133,104,96,54,-83,-80,-37,-66,-79,-129,-115,-149,-76,-97,-91,-145,-81,-102,-138,-142,FLAT
107,116,15,131,90,133,104,96,-66,45,4,107,-149,-35,-33,41,-145,-84,-111,-42,-142,-52,-87,-38,FLAT
-20,13,89,102,131,90,133,104,107,54,83,-20,41,99,87,87,-42,19,50,21,-38,-30,-28,-62,FLAT
-16,67,31,98,102,131,90,133,-20,-74,-70,-16,87,-20,13,-36,21,25,17,71,-62,-55,-20,5,FLAT
27,56,7,63,98,102,131,90,-16,3,38,27,-36,-71,-32,11,71,-17,51,-9,5,28,55,98,FLAT
31,40,54,94,63,98,102,131,27,78,47,31,11,81,85,58,-9,7,15,42,98,61,98,22,FLAT
-61,5,69,74,84,68,68,94,-53,-75,-65,-61,-55,-63,-69,-114,-66,-79,-85,-116,-35,-112,-92,-127,FLAT
-33,40,43,83,74,84,68,68,-61,-59,-68,-33,-114,-134,-133,-94,-116,-122,-137,-147,-127,-138,-153,-149,FLAT
0,35,18,53,83,74,84,68,-33,-25,5,0,-94,-84,-63,-33,-147,-159,-128,-94,-149,-147,-132,-147,FLAT
0,26,53,79,53,83,74,84,0,35,9,0,-33,10,14,0,-94,-49,-54,-33,-147,-124,-119,-94,FLAT
31,46,22,68,79,53,83,74,0,0,11,31,0,35,20,31,-33,10,25,31,-94,-49,-43,-2,FLAT
37,50,28,78,68,79,53,83,31,43,33,37,31,43,44,68,31,78,53,68,-2,53,58,68,FLAT
-1,2,51,53,78,68,79,53,37,22,47,-1,68,65,80,36,68,65,91,67,68,100,100,67,FLAT
-85,7,105,112,53,78,68,79,-1,-31,-90,-85,36,-9,-43,-86,67,34,-10,-49,67,34,1,-18,FLAT
-19,4,84,88,112,53,78,68,-85,-40,-16,-19,-86,-71,-106,-104,-49,-49,-59,-105,-18,-6,-26,-68,FLAT
2,39,14,53,88,112,53,78,-19,-68,-33,2,-104,-108,-49,-17,-105,-139,-139,-102,-68,-117,-92,-103,FLAT
65,76,19,95,53,88,112,53,2,70,28,65,-17,2,-5,67,-102,-38,-21,48,-103,-69,-111,-37,FLAT
61,68,13,81,95,53,88,112,65,55,69,61,67,125,97,126,48,57,64,128,-37,17,48,109,FLAT
-372,46,480,526,81,95,53,88,61,95,-350,-372,126,150,-281,-311,128,220,-253,-246,109,152,-286,-244,FLAT
33,123,84,207,526,81,95,53,-372,-363,-44,33,-311,-268,-394,-339,-246,-213,-325,-278,-244,-143,-297,-213,FLAT
-76,56,193,249,207,526,81,95,33,33,-9,-76,-339,-330,-53,-43,-278,-235,-403,-415,-213,-180,-334,-354,FLAT
-54,25,95,120,249,207,526,81,-76,-152,-23,-54,-43,-119,-32,-130,-415,-482,-76,-97,-354,-387,-426,-469,FLAT
-42,20,142,162,120,249,207,526,-54,5,-37,-42,-130,-147,-60,-96,-97,-114,-69,-172,-469,-477,-113,-139,FLAT
96,109,4,113,207,162,120,249,142,73,167,96,100,100,149,238,46,105,112,196,-30,-47,89,142,FLAT
-74,34,109,143,113,207,162,120,96,31,1,-74,238,104,168,22,196,131,150,164,142,136,113,122,FLAT
-6,10,95,105,143,113,207,162,-74,-20,18,-6,22,11,19,-80,164,84,186,16,122,111,168,158,FLAT
-10,57,55,112,105,143,113,207,-6,-50,-57,-10,-80,-70,-39,-16,16,-39,-38,-90,158,34,129,6,FLAT
53,99,10,109,112,105,143,113,-10,8,11,53,-16,-42,-46,43,-90,-62,-28,37,6,-31,-27,-37,FLAT
100,110,4,114,109,112,105,143,53,94,89,100,43,102,100,153,37,52,43,143,-37,32,61,137,FLAT
-46,5,56,61,114,109,112,105,100,6,59,-46,153,100,148,54,143,108,159,107,137,58,102,97,FLAT
-59,4,73,77,61,114,109,112,-46,-42,-58,-59,54,-36,1,-105,107,58,90,-5,97,66,101,48,FLAT
-22,0,70,70,77,61,114,109,-59,-25,-18,-22,-105,-67,-76,-81,-5,-61,-17,-127,48,33,72,-27,FLAT
-6,12,41,53,70,77,61,114,-22,-35,-18,-6,-81,-60,-36,-28,-127,-102,-94,-87,-27,-96,-35,-133,FLAT
6,25,7,32,53,70,77,61,-6,-28,-7,6,-28,-63,-25,0,-87,-88,-43,-22,-133,-130,-101,-81,FLAT
-48,14,55,69,32,53,70,77,6,0,-37,-48,0,-28,-44,-42,-22,-63,-62,-48,-81,-88,-80,-70,FLAT
39,70,0,70,69,32,53,70,-48,-16,-17,39,-42,-16,-54,-9,-48,-44,-61,-3,-70,-79,-79,-9,FLAT
65,65,3,68,70,69,32,53,39,68,70,65,-9,52,53,104,-3,52,16,56,-9,24,9,62,FLAT
38,44,6,50,68,70,69,32,65,41,59,38,104,109,129,103,56,93,112,142,62,93,75,94,FLAT
-3,17,23,40,50,68,70,69,38,14,24,-3,103,55,83,35,142,123,153,100,94,107,136,139,FLAT
1,6,13,19,31,85,48,38,12,-5,7,1,45,-2,64,13,24,12,41,46,15,13,32,25,FLAT
-90,2,116,118,19,31,85,48,1,13,-86,-90,13,8,-79,-89,46,11,-22,-77,25,25,-45,-44,FLAT
3,26,20,46,118,19,31,85,-90,-93,-21,3,-89,-80,-107,-87,-77,-85,-100,-86,-44,-82,-43,-74,FLAT
11,20,10,30,46,118,19,31,3,1,17,11,-87,-92,-4,14,-86,-79,-90,-76,-74,-84,-83,-75,FLAT
17,28,9,37,30,46,118,19,11,16,9,17,14,17,26,28,-76,-76,5,31,-75,-63,-81,-59,FLAT
-14,8,32,40,37,30,46,118,17,9,6,-14,28,25,15,3,31,26,32,14,-59,-67,11,17,FLAT
31,36,26,62,40,37,30,46,-14,25,3,31,3,34,9,17,14,50,18,34,17,51,35,45,FLAT
5,8,66,74,62,40,37,30,31,45,33,5,17,70,36,36,34,79,42,22,45,95,51,39,FLAT
-34,67,34,101,74,62,40,37,5,-66,-93,-34,36,-21,-60,-29,22,4,-57,2,39,13,-51,-12,FLAT
-21,41,29,70,101,74,62,40,-34,-26,5,-21,-29,-92,-88,-55,2,-47,-55,-50,-12,-22,-52,-19,FLAT
7,43,5,48,70,101,74,62,-21,-17,5,7,-55,-43,10,-14,-50,-109,-83,-48,-19,-64,-50,-43,FLAT
-49,0,112,112,48,70,101,74,7,58,-6,-49,-14,41,-1,-42,-48,15,4,-63,-43,-51,-89,-97,FLAT
195,195,113,308,112,48,70,101,-49,196,0,195,-42,254,-6,146,-63,237,-1,153,-97,211,4,132,FLAT
-240,10,240,250,308,112,48,70,195,-113,-55,-240,146,83,-55,-45,153,141,-61,-94,132,124,-56,-87,FLAT
43,120,23,143,250,308,112,48,-240,-174,-67,43,-45,-287,-122,-197,-94,-91,-122,-2,-87,-33,-128,-51,FLAT
-88,4,120,124,143,250,308,112,43,9,28,-88,-197,-165,-39,-45,-2,-278,-94,-285,-51,-82,-94,-90,FLAT
117,124,1,125,124,143,250,308,-88,-2,-3,117,-45,7,25,29,-285,-167,-42,72,-90,-280,-97,-168,FLAT
-272,0,283,283,125,124,143,250,117,10,-148,-272,29,8,-151,-155,72,17,-123,-243,-168,-157,-190,-200,FLAT
-19,7,82,89,283,125,124,143,-272,-220,-26,-19,-155,-210,-174,-291,-243,-212,-177,-174,-200,-203,-149,-262,FLAT
83,113,1,114,89,283,125,124,-19,2,-23,83,-291,-218,-49,64,-174,-208,-197,-208,-262,-210,-200,-91,FLAT
33,103,0,103,114,89,283,125,83,32,43,33,64,34,20,116,-208,-186,-6,97,-91,-176,-154,-175,FLAT
-40,55,43,98,103,114,89,283,33,3,8,-40,116,35,51,-7,97,37,28,76,-175,-183,2,57,FLAT
14,27,54,81,98,103,114,89,-40,25,42,14,-7,28,50,-26,76,60,93,7,57,62,70,90,FLAT
-20,9,57,66,81,98,103,114,14,-17,-2,-20,-26,8,40,-6,7,11,48,-46,90,43,91,-13,FLAT
13,52,20,72,66,81,98,103,-20,-24,-30,13,-6,-41,-32,-7,-46,-16,10,7,-13,-13,18,-33,FLAT
9,62,11,73,72,66,81,98,13,0,-1,9,-7,-24,-31,22,7,-41,-33,2,-33,-16,9,16,FLAT
52,60,45,105,73,72,66,81,9,86,54,52,22,86,53,61,2,62,23,74,16,45,21,54,FLAT
-17,38,20,58,105,73,72,66,52,-42,5,-17,61,44,59,35,74,44,58,44,54,20,28,57,FLAT
-85,15,87,102,58,105,73,72,-17,-18,-62,-85,35,-60,-57,-102,44,26,-3,-50,57,26,-4,-41,FLAT
12,41,11,52,102,58,105,73,-85,-64,-14,12,-102,-82,-76,-73,-50,-124,-71,-90,-41,-38,-17,-38,FLAT
29,44,5,49,52,102,58,105,12,23,26,29,-73,-41,12,41,-90,-59,-50,-44,-38,-101,-45,-61,FLAT
-67,4,69,73,49,52,102,58,29,-3,-27,-67,41,20,-1,-38,-44,-44,-15,-26,-61,-62,-77,-111,FLAT
-74,15,102,117,73,49,52,102,-67,-41,-85,-74,-38,-44,-112,-141,-26,-21,-86,-112,-111,-85,-100,-100,FLAT
53,57,52,109,117,73,49,52,-74,3,11,53,-141,-38,-74,-21,-112,-41,-101,-88,-100,-18,-75,-59,FLAT
-25,49,31,80,109,117,73,49,53,-46,-17,-25,-21,-43,-6,28,-88,-84,-91,-46,-59,-87,-118,-113,FLAT
-53,89,243,332,80,109,117,73,-25,159,-93,-53,28,113,-110,-78,-46,116,-99,-25,-113,75,-184,-99,FLAT
289,307,26,333,144,332,80,109,131,310,121,289,78,203,202,420,53,362,109,367,106,316,92,342,FLAT
-78,42,86,128,333,144,332,80,289,-18,187,-78,420,292,308,211,367,185,389,342,342,344,296,289,FLAT
-98,15,149,164,128,333,144,332,-78,-35,-71,-98,211,-53,116,-176,342,257,237,113,289,150,318,244,FLAT
16,49,50,99,217,85,164,128,81,33,151,16,134,129,115,97,36,51,116,150,-42,16,45,52,FLAT
152,159,7,166,99,217,85,164,16,109,42,152,97,142,193,168,150,238,157,249,52,160,158,302,FLAT
109,198,46,244,166,99,217,85,152,148,70,109,168,257,112,261,249,290,263,277,302,386,227,358,FLAT
-31,37,102,139,244,166,99,217,109,25,130,-31,261,173,200,78,277,282,242,230,358,315,393,246,FLAT
20,68,84,152,139,244,166,99,-31,2,-11,20,78,27,119,-11,230,175,189,98,246,284,231,250,FLAT
59,59,33,92,152,139,244,166,20,8,68,59,-11,10,57,79,98,35,187,48,250,183,257,157,FLAT
-21,10,63,73,62,79,92,152,-46,-15,-26,-21,-67,-44,-38,-67,-8,-58,-39,-88,12,-50,29,-29,FLAT
-20,5,54,59,73,62,79,92,-21,-29,-15,-20,-67,-44,-41,-41,-88,-73,-53,-87,-29,-87,-54,-108,FLAT
1,27,29,56,59,73,62,79,-20,-24,-21,1,-41,-53,-36,-19,-87,-68,-62,-40,-108,-97,-74,-86,FLAT
-44,13,45,58,56,59,73,62,1,-28,-30,-44,-19,-52,-51,-43,-40,-81,-66,-63,-86,-96,-92,-84,FLAT
5,17,24,41,58,56,59,73,-44,-16,1,5,-43,-44,-29,-39,-63,-68,-50,-38,-84,-97,-65,-58,FLAT
-1,50,12,62,41,58,56,59,5,-13,-34,-1,-39,-29,-33,4,-38,-57,-63,-40,-58,-81,-84,-39,FLAT
-31,18,39,57,62,41,58,56,-1,-4,1,-31,4,-17,-33,-32,-40,-33,-32,-27,-39,-61,-62,-71,FLAT
47,51,0,51,30,36,52,35,-21,26,5,47,-1,19,4,26,12,33,34,46,34,59,43,59,FLAT
-24,10,27,37,51,30,36,52,47,3,17,-24,26,29,22,23,46,22,21,2,59,36,51,22,FLAT
18,36,0,36,37,51,30,36,-24,-9,-8,18,23,-6,9,-6,2,20,14,41,22,13,13,20,FLAT
-21,31,25,56,53,36,37,51,-50,-48,-51,-21,-32,-46,-66,-71,-56,-55,-74,-53,-9,-52,-57,-77,FLAT
-18,8,19,27,56,53,36,37,-21,-24,5,-18,-71,-72,-46,-39,-53,-70,-61,-89,-77,-79,-69,-71,FLAT
-12,7,27,34,27,56,53,36,-18,-4,-11,-12,-39,-28,-6,-30,-89,-76,-57,-51,-71,-74,-72,-101,FLAT
40,65,6,71,34,27,56,53,-12,19,-18,40,-30,15,-29,28,-51,-9,-24,10,-101,-57,-75,-11,FLAT
-13,16,29,45,71,34,27,56,40,10,36,-13,28,29,18,27,10,25,7,15,-11,1,12,-3,FLAT
-34,16,40,56,45,71,34,27,-13,-23,-34,-34,27,-13,2,-47,15,6,-16,-7,-3,2,-27,-19,FLAT
-59,18,59,77,56,45,71,34,-34,-40,-61,-59,-47,-63,-95,-93,-7,-53,-59,-106,-19,-34,-77,-66,FLAT
49,68,2,70,77,56,45,71,-59,-8,-1,49,-93,-48,-62,-10,-106,-71,-96,-44,-66,-61,-60,-57,FLAT
-40,12,79,91,70,77,56,45,49,37,16,-40,-10,29,15,9,-44,-11,-46,-50,-57,-34,-80,-84,FLAT
11,11,58,69,91,70,77,56,-40,-10,12,11,9,27,28,-29,-50,19,27,20,-84,-21,-34,-39,FLAT
35,50,35,85,69,91,70,77,11,12,-4,35,-29,2,8,46,20,39,24,6,-39,31,23,55,FLAT
-19,41,44,85,85,69,91,70,35,-10,-10,-19,46,2,-14,16,6,-8,-2,27,55,29,14,-13,FLAT
31,60,0,60,85,85,69,91,-19,-13,12,31,16,-23,2,12,27,-11,-2,47,-13,-21,10,58,FLAT
-42,17,42,59,60,85,85,69,31,0,1,-42,12,-13,13,-11,47,-23,3,-30,58,-11,-1,5,FLAT
-49,25,49,74,59,60,85,85,-42,-42,-57,-49,-11,-42,-56,-91,-30,-55,-44,-60,5,-65,-54,-79,FLAT
15,45,8,53,74,59,60,85,-49,-26,-5,15,-91,-68,-62,-34,-60,-68,-61,-76,-79,-81,-49,-45,FLAT
-36,8,53,61,53,74,59,60,15,9,1,-36,-34,-17,-4,-21,-76,-59,-61,-70,-45,-59,-60,-112,FLAT
25,65,8,73,61,53,74,59,-36,-20,-32,25,-21,-11,-31,-11,-70,-37,-36,4,-112,-79,-93,-45,FLAT
11,15,13,28,36,73,73,61,19,23,31,11,75,36,81,30,100,91,136,86,64,71,104,111,FLAT
-11,3,46,49,28,36,73,73,11,22,1,-11,30,45,32,0,86,58,82,19,111,113,137,75,FLAT
-1,23,11,34,49,28,36,73,-11,-36,-21,-1,0,-14,-20,-12,19,9,11,-1,75,22,61,18,FLAT
42,56,1,57,34,49,28,36,-1,32,9,42,-12,-4,-12,41,-1,18,-11,30,18,41,20,41,FLAT
26,43,7,50,57,34,49,28,42,32,39,26,41,64,48,68,30,28,27,67,41,50,28,56,FLAT
-19,2,31,33,50,57,34,49,26,5,22,-19,68,37,61,7,67,69,70,49,56,33,49,48,FLAT
39,46,10,56,33,50,57,34,-19,18,-5,39,7,23,17,20,49,55,56,46,48,87,65,88,FLAT
-4,16,34,50,56,33,50,57,39,20,26,-4,20,38,21,35,46,43,43,16,88,75,82,42,FLAT
28,50,9,59,50,56,33,50,-4,3,-6,28,35,23,20,24,16,41,15,63,42,46,37,44,FLAT
-15,41,15,56,59,50,56,33,28,-9,-6,-15,24,-6,-12,13,63,14,14,9,44,32,9,48,FLAT
47,48,36,84,56,59,50,56,-15,68,40,47,13,59,34,32,9,62,28,60,48,82,54,56,FLAT
134,166,4,170,84,56,59,50,47,102,16,134,32,170,56,181,60,161,50,166,56,164,44,194,FLAT
30,78,8,86,170,84,56,59,134,34,118,30,181,136,134,164,166,204,174,211,194,195,168,196,FLAT
-64,3,91,94,86,170,84,56,30,19,11,-64,164,53,129,-34,211,155,145,100,196,223,185,147,FLAT
-44,8,86,94,44,80,94,86,-16,9,-41,-44,-33,-14,-28,-60,-97,-82,-82,-77,-67,-63,-71,-141,FLAT
-226,13,226,239,94,44,80,94,-44,-86,-231,-226,-60,-77,-272,-270,-77,-100,-259,-286,-141,-168,-313,-303,FLAT
-110,19,129,148,239,94,44,80,-226,-207,-116,-110,-270,-293,-347,-336,-286,-284,-388,-380,-303,-307,-375,-396,FLAT
-49,20,116,136,148,239,94,44,-110,-62,-50,-49,-336,-269,-166,-159,-380,-355,-397,-385,-396,-346,-438,-429,FLAT
13,37,46,83,136,148,239,94,-49,-57,-4,13,-159,-119,-54,-36,-385,-326,-170,-146,-429,-412,-401,-372,FLAT
-102,17,107,124,83,136,148,239,13,-41,-82,-102,-36,-98,-86,-89,-146,-160,-136,-138,-372,-367,-252,-248,FLAT
-25,10,70,80,124,83,136,148,-102,-62,-18,-25,-89,-103,-100,-127,-138,-160,-104,-114,-248,-222,-154,-163,FLAT
-5,24,28,52,80,124,83,136,-25,-47,-19,-5,-127,-109,-37,-30,-114,-150,-119,-132,-163,-207,-123,-119,FLAT
10,25,25,50,52,80,124,83,-5,7,9,10,-30,-40,-10,5,-132,-102,-28,-20,-119,-143,-110,-122,FLAT
-44,6,56,62,50,52,80,124,10,-13,-25,-44,5,-6,-16,-34,-20,-53,-35,-39,-122,-115,-53,-64,FLAT
12,20,9,29,62,50,52,80,-44,-35,-2,12,-34,-48,-27,-32,-39,-41,-18,-22,-64,-88,-37,-27,FLAT
18,32,35,67,29,62,50,52,12,44,6,18,-32,9,4,30,-22,-4,-21,-14,-27,3,-12,-4,FLAT
-5,10,31,41,67,29,62,50,18,-9,17,-5,30,35,23,13,-14,0,21,25,-4,-13,-4,-19,FLAT
19,33,3,36,41,67,29,62,-5,-9,-4,19,13,-18,13,14,25,26,19,32,-19,-9,17,44,FLAT
17,19,5,24,36,41,67,29,19,19,31,17,14,10,27,36,32,1,44,31,44,45,50,49,FLAT
-36,22,40,62,24,36,41,67,17,-1,-39,-36,36,18,-8,-19,31,9,-12,0,49,0,5,-5,FLAT
46,49,0,49,62,24,36,41,-36,6,19,46,-19,5,-20,10,0,24,11,27,-5,15,7,46,FLAT
-21,7,21,28,22,27,17,27,-4,-9,-15,-21,-16,-19,-20,-25,-25,-26,-37,-37,-8,-33,-34,-46,FLAT
3,9,13,22,28,22,27,17,-21,-5,1,3,-25,-14,-14,-18,-37,-24,-19,-22,-46,-31,-36,-34,FLAT
-23,5,38,43,22,28,22,27,3,2,-19,-23,-18,-3,-18,-20,-22,-12,-33,-41,-34,-22,-38,-45,FLAT
6,36,66,102,43,22,28,22,-23,34,-25,6,-20,36,-44,-17,-41,31,-43,-14,-45,22,-58,-35,FLAT
30,40,6,46,56,102,43,22,19,5,15,30,25,-11,45,49,2,23,20,55,5,25,1,32,FLAT
35,45,4,49,46,56,102,43,30,33,30,35,49,38,45,65,55,22,75,84,32,56,50,90,FLAT
-33,9,51,60,49,46,56,102,35,14,3,-33,65,47,33,2,84,52,48,32,90,36,78,51,FLAT
-42,2,53,55,60,49,46,56,-33,-40,-35,-42,2,-26,-32,-75,32,7,-2,-40,51,12,13,-10,FLAT
36,40,47,87,55,60,49,46,-42,30,-2,36,-75,-10,-37,-6,-40,4,-34,-39,-10,37,-4,-4,FLAT
25,31,26,57,87,55,60,49,36,4,34,25,-6,34,32,61,-39,-6,-3,19,-4,8,0,-14,FLAT
-19,22,29,51,57,87,55,60,25,-16,-10,-19,61,-12,24,6,19,18,22,42,-14,-22,-13,0,FLAT
38,68,33,101,51,57,87,55,-19,42,-8,38,6,26,-18,19,42,30,16,44,0,60,14,80,FLAT
75,91,27,118,101,51,57,87,38,69,52,75,19,111,44,113,44,95,34,94,80,99,68,119,FLAT
-23,0,99,99,118,101,51,57,75,49,68,-23,113,118,120,52,94,160,112,90,119,144,102,71,FLAT
49,75,30,105,99,118,101,51,-23,-20,-26,49,52,29,42,26,90,98,94,101,71,140,86,139,FLAT
-205,53,216,269,205,105,99,118,-160,-161,-225,-205,-111,-179,-343,-365,-134,-199,-369,-316,-59,-150,-301,-339,FLAT
54,70,60,130,269,205,105,99,-205,-102,37,54,-365,-263,-188,-151,-316,-281,-306,-311,-339,-301,-332,-262,FLAT
39,76,3,79,130,269,205,105,54,-18,33,39,-151,-120,70,93,-311,-281,-155,-112,-262,-299,-273,-272,FLAT
-26,0,130,130,79,130,269,205,39,101,50,-26,93,83,83,13,-112,-19,120,67,-272,-180,-105,-138,FLAT
-22,1,121,122,130,79,130,269,-26,-31,-23,-22,13,70,27,-48,67,52,60,-9,-138,-50,97,45,FLAT
-144,16,165,181,122,130,79,130,-22,-100,-159,-144,-48,-131,-182,-166,-9,-30,-132,-192,45,-48,-99,-153,FLAT
28,62,28,90,181,122,130,79,-144,-109,-18,28,-166,-209,-177,-116,-192,-240,-200,-138,-153,-139,-150,-164,FLAT
-53,35,75,110,90,181,122,130,28,-6,-26,-53,-116,-115,-44,-25,-138,-215,-203,-169,-164,-246,-226,-191,FLAT
62,108,9,117,110,90,181,122,-53,-4,-11,62,-25,-10,-37,9,-169,-119,-55,37,-191,-219,-214,-107,FLAT
-42,46,53,99,117,110,90,181,62,2,20,-42,9,-2,9,20,37,-8,-17,-33,-107,-117,-35,-5,FLAT
7,61,1,62,99,117,110,90,-42,-45,-8,7,20,-43,12,-35,-33,-47,1,27,-5,-53,-25,-26,FLAT
16,23,28,51,62,99,117,110,7,43,54,16,-35,-2,46,23,27,0,66,-19,-26,-4,55,43,FLAT
160,162,10,172,51,62,99,117,16,142,21,160,23,185,75,176,-19,140,67,183,43,142,87,141,FLAT
-17,15,50,65,172,51,62,99,160,23,130,-17,176,165,151,143,183,208,205,159,141,163,197,166,FLAT
-32,22,32,54,65,172,51,62,-17,-50,-39,-32,143,-27,91,-49,159,115,112,111,166,158,166,127,FLAT
-4,27,18,45,54,65,172,51,-32,-18,-9,-4,-49,-68,-48,-36,111,-45,82,-53,127,97,103,107,FLAT
-61,1,67,68,45,54,65,172,-4,-12,-35,-61,-36,-30,-44,-65,-53,-80,-83,-97,107,-57,47,-114,FLAT
35,42,31,73,68,45,54,65,-61,-1,-6,35,-65,-13,-41,-26,-97,-31,-50,-30,-114,-81,-89,-62,FLAT
39,88,5,93,73,68,45,54,35,13,-7,39,-26,12,-13,74,-30,0,-48,13,-62,-18,-57,9,FLAT
-138,9,155,164,93,73,68,45,39,12,-59,-138,74,25,-66,-99,13,24,-72,-64,9,12,-107,-125,FLAT
-60,4,88,92,164,93,73,68,-138,-127,-55,-60,-99,-115,-114,-198,-64,-102,-121,-159,-125,-103,-127,-124,FLAT
55,58,4,62,92,164,93,73,-60,-29,1,55,-198,-156,-54,-5,-159,-144,-113,-143,-124,-131,-120,-104,FLAT
23,59,5,64,62,92,164,93,55,24,22,23,-5,-5,23,78,-143,-132,-32,18,-104,-120,-91,-120,FLAT
-129,20,152,172,64,62,92,164,23,18,-90,-129,78,42,-68,-106,18,13,-67,-51,-120,-114,-122,-111,FLAT
171,176,102,278,172,64,62,92,-129,121,15,171,-106,139,-75,42,-51,163,-53,65,-111,134,-52,120,FLAT
-25,66,41,107,278,172,64,62,171,-86,85,-25,42,35,100,146,65,53,10,17,120,77,32,40,FLAT
332,332,14,346,107,278,172,64,-25,305,66,332,146,219,151,307,17,340,166,478,40,358,76,349,FLAT
-129,50,132,182,346,107,278,172,332,-11,153,-129,307,294,219,203,478,208,304,178,349,329,319,349,FLAT
80,95,18,113,182,346,107,278,-129,-34,35,80,203,-45,188,-49,178,260,254,283,349,174,339,258,FLAT
-47,19,89,108,113,182,346,107,80,24,29,-47,-49,-10,64,33,283,-21,217,-96,258,284,283,236,FLAT
61,84,11,95,108,113,182,346,-47,-17,-4,61,33,7,25,14,-96,-27,60,94,236,-38,213,-35,FLAT
83,122,8,130,95,108,113,182,61,80,45,83,14,63,41,144,94,87,70,97,-35,53,105,177,FLAT
0,11,58,69,130,95,108,113,83,50,111,0,144,130,156,83,97,113,152,144,177,137,181,97,FLAT
7,20,38,58,69,130,95,108,0,-13,-2,7,83,37,109,7,144,117,154,90,97,100,150,151,FLAT
15,49,11,60,58,69,130,95,7,-12,-14,15,7,-25,-16,22,90,25,95,22,151,105,140,105,FLAT
9,9,33,42,60,58,69,130,15,31,49,9,22,19,35,24,22,6,33,31,105,56,144,31,FLAT
-35,3,48,51,42,60,58,69,9,-20,-29,-35,24,11,20,-26,31,-1,6,-11,31,-14,4,-4,FLAT
25,42,0,42,51,42,60,58,-35,-23,-14,25,-26,-43,-43,-10,-11,-12,6,-1,-4,-24,-8,14,FLAT
33,39,2,41,42,51,42,60,25,35,36,33,-10,12,22,58,-1,-8,-7,23,14,23,42,32,FLAT
-48,1,63,64,41,42,51,42,33,13,-10,-48,58,48,26,-15,23,25,12,10,32,5,-17,-25,FLAT
21,30,4,34,25,33,42,19,1,21,12,21,-15,7,6,22,21,7,15,6,30,41,26,42,FLAT
-22,0,22,22,34,25,33,42,21,-4,8,-22,22,17,20,-1,6,3,14,0,42,3,23,-16,FLAT
-37,0,37,37,22,34,25,33,-22,-22,-37,-37,-1,-26,-29,-59,0,-5,-17,-38,-16,-19,-23,-37,FLAT
11,26,2,28,37,22,34,25,-37,-24,-15,11,-59,-46,-52,-26,-38,-50,-44,-48,-37,-29,-32,-27,FLAT
-31,4,41,45,28,37,22,34,11,8,-9,-31,-26,-16,-24,-20,-48,-38,-61,-57,-27,-42,-53,-79,FLAT
43,43,0,43,45,28,37,22,-31,2,4,43,-20,10,-5,12,-57,-14,-20,23,-79,-36,-57,-14,FLAT
-33,15,39,54,43,45,28,37,43,6,-5,-33,12,8,-1,10,23,16,-10,-21,-14,-8,-25,-10,FLAT
-3,12,12,24,54,43,45,28,-33,-30,0,-3,10,-24,-5,-36,-21,-22,-1,7,-10,-14,-10,-24,FLAT
-22,18,29,47,24,54,43,45,-3,-5,-28,-22,-36,-35,-28,-25,7,-29,-33,-58,-24,-27,-29,-15,FLAT
-33,5,69,74,47,24,54,43,-22,7,-20,-33,-25,2,-48,-55,-58,-28,-48,-58,-15,-22,-53,-91,FLAT
24,50,12,62,74,47,24,54,-33,-33,-21,24,-55,-26,-41,-9,-58,-31,-69,-31,-91,-61,-69,-34,FLAT
32,54,12,66,120,62,74,47,83,22,76,32,107,115,111,115,74,82,90,139,52,89,70,106,FLAT
19,67,19,86,66,120,62,74,32,26,6,19,115,48,82,51,139,141,117,134,106,108,96,158,FLAT
59,65,27,92,86,66,120,62,19,67,61,59,51,93,67,78,134,115,143,110,158,208,178,193,FLAT
-50,9,79,88,92,86,66,120,59,2,6,-50,78,69,67,9,110,95,73,28,193,117,149,60,FLAT
8,49,10,59,88,92,86,66,-50,-61,-32,8,9,-59,-26,-42,28,8,35,17,60,34,41,36,FLAT
22,22,81,103,59,88,92,86,8,93,49,22,-42,32,17,30,17,34,23,-20,36,101,84,39,FLAT
12,22,30,52,103,59,88,92,22,-39,12,12,30,54,61,34,-20,-7,29,42,39,-5,35,-8,FLAT
81,114,7,121,52,103,59,88,12,58,-11,81,34,19,1,93,42,112,50,115,-8,51,18,123,FLAT
-62,1,71,72,121,52,103,59,81,2,51,-62,93,60,40,19,115,21,52,31,123,114,101,53,FLAT
35,43,38,81,72,121,52,103,-62,2,-7,35,19,4,44,-27,31,62,33,54,53,23,45,66,FLAT
11,51,16,67,81,72,121,52,35,-11,3,11,-27,-9,-4,46,54,-7,47,-16,66,51,36,65,FLAT
-45,32,47,79,67,81,72,121,11,-14,-26,-45,46,-25,-23,-34,-16,-23,-30,1,65,-21,21,-61,FLAT
7,27,32,59,79,67,81,72,-45,-8,12,7,-34,-22,-14,-38,1,-33,-11,-27,-61,-31,-18,8,FLAT
-11,56,12,68,59,79,67,81,7,-31,-40,-11,-38,-39,-28,-4,-27,-53,-54,-49,8,-64,-51,-38,FLAT
-31,36,35,71,68,59,79,67,-11,-8,-11,-31,-4,-39,-51,-42,-49,-47,-39,-35,-38,-61,-65,-80,FLAT
-2,36,24,60,71,68,59,79,-31,-13,-2,-2,-42,-21,-13,-33,-35,-52,-53,-44,-80,-60,-41,-37,FLAT
-31,33,31,64,60,71,68,59,-2,-24,-28,-31,-33,-37,-30,-33,-44,-45,-41,-64,-37,-76,-81,-75,FLAT
52,63,14,77,64,60,71,68,-31,35,22,52,-33,11,-6,21,-64,-2,-8,19,-75,-10,-19,-12,FLAT
4,48,11,59,77,64,60,71,52,1,19,4,21,36,41,56,19,12,13,25,-12,-1,11,23,FLAT
20,79,32,111,59,77,64,60,4,41,-11,20,56,42,8,24,25,77,30,76,23,53,2,45,FLAT
-10,54,33,87,111,59,77,64,20,-9,15,-10,24,32,4,10,76,33,23,14,45,68,45,66,FLAT
21,37,19,56,87,111,59,77,-10,7,38,21,10,-2,53,11,14,39,42,31,66,40,61,35,FLAT
-41,153,62,215,56,87,111,59,21,2,-157,-41,11,9,-119,-20,31,0,-104,-30,35,41,-115,-10,FLAT
-40,3,86,89,215,56,87,111,-41,-16,110,-40,-20,-14,-47,-81,-30,-7,-9,-60,-10,-16,6,-70,FLAT
50,68,15,83,89,215,56,87,-40,-21,-15,50,-81,-37,95,10,-60,-35,-62,-31,-70,-28,-24,-10,FLAT
24,73,26,99,83,89,215,56,50,35,19,24,10,14,4,74,-31,-2,114,34,-10,0,-43,-7,FLAT
-28,20,38,58,99,83,89,215,24,-16,25,-28,74,19,44,-4,34,-2,29,46,-7,-18,139,6,FLAT
-16,54,40,94,58,99,83,89,-28,-14,-50,-16,-4,-30,-25,-44,46,5,-6,-20,6,-16,-21,30,FLAT
-43,29,65,94,94,58,99,83,-16,-18,-18,-43,-44,-32,-68,-59,-20,-48,-43,-87,30,-13,-24,-63,FLAT
164,164,52,216,94,94,58,99,-43,151,29,164,-59,133,11,121,-87,119,-39,105,-63,103,-14,77,FLAT
-33,60,69,129,216,94,94,58,164,-16,71,-33,121,135,100,131,105,117,82,88,77,103,32,72,FLAT
92,108,1,109,129,216,94,94,-33,24,44,92,131,8,115,59,88,159,144,223,72,141,126,180,FLAT
-18,65,66,131,109,129,216,94,92,47,25,-18,59,71,69,74,223,55,140,41,180,206,169,205,FLAT
45,72,11,83,131,109,129,216,-18,-10,38,45,74,37,63,27,41,61,107,119,205,45,178,86,FLAT
-23,4,39,43,83,131,109,129,45,5,45,-23,27,-5,83,22,119,42,108,4,86,66,152,96,FLAT
-10,55,27,82,43,83,131,109,-23,-22,-61,-10,22,-17,-16,-33,4,-27,22,12,96,20,47,-6,FLAT
-61,1,69,70,82,43,83,131,-10,-19,-7,-61,-33,-41,-68,-71,12,-36,-23,-94,-6,-46,15,-49,FLAT
33,48,9,57,70,82,43,83,-61,-27,-14,33,-71,-46,-21,-28,-94,-68,-82,-38,-49,-63,-37,-61,FLAT
0,65,14,79,57,70,82,43,33,5,-17,0,-28,-22,-31,33,-38,-41,-38,-28,-61,-63,-99,-38,FLAT
10,78,7,85,79,57,70,82,0,3,-3,10,33,8,-20,10,-28,-19,-34,43,-38,-38,-41,-18,FLAT
-53,17,56,73,85,79,57,70,10,-4,8,-53,10,-1,5,-43,43,4,-12,-43,-18,-23,-26,-10,FLAT
1,53,8,61,73,85,79,57,-53,-47,-35,1,-43,-51,-27,-52,-43,-48,-30,-42,-10,-43,-47,-42,FLAT
25,30,1,31,61,73,85,79,1,18,48,25,-52,-29,13,26,-42,-33,21,-27,-42,-30,18,-17,FLAT
13,42,11,53,31,61,73,85,25,23,1,13,26,41,49,38,-27,-6,14,39,-17,-10,22,-14,FLAT
-6,35,31,66,53,31,61,73,13,14,1,-6,38,37,2,7,39,55,50,32,-14,8,15,33,FLAT
8,12,10,22,47,41,31,61,-43,-27,-2,8,-37,-31,-12,-35,-35,-36,-27,-29,-17,-54,-15,-27,FLAT
-1,3,23,26,22,47,41,31,8,12,8,-1,-35,-15,6,7,-29,-19,-4,-36,-27,-24,-19,-30,FLAT
6,24,18,42,26,22,47,41,-1,1,-15,6,7,13,-7,5,-36,-14,-9,13,-30,-18,-19,-30,FLAT
44,46,11,57,42,26,22,47,6,37,22,44,5,38,7,50,13,50,15,49,-30,23,13,57,FLAT
-48,3,48,51,57,42,26,22,44,-11,-5,-48,50,26,17,-4,49,27,2,2,57,39,10,1,FLAT
34,50,5,55,51,57,42,26,-48,-9,-13,34,-4,-20,-18,-14,2,17,4,30,1,18,-11,36,FLAT
-12,4,19,23,55,51,57,42,34,2,34,-12,-14,-7,21,22,30,-18,16,-26,36,19,38,18,FLAT
9,13,34,47,23,55,51,57,-12,24,0,9,22,26,34,-3,-26,17,21,31,18,6,16,-17,FLAT
-4,22,22,44,47,23,55,51,9,-16,-13,-4,-3,8,-13,5,31,10,21,-7,-17,1,8,27,FLAT
65,102,5,107,44,47,23,55,-4,48,-15,65,5,32,-28,61,-7,56,-28,70,27,58,6,58,FLAT
-19,63,29,92,107,44,47,23,65,5,20,-19,61,53,5,46,70,37,-8,42,58,61,-8,51,FLAT
8,27,47,74,158,92,107,44,-140,-86,-2,8,-159,-114,-96,-132,-94,-109,-76,-151,-98,-61,-91,-86,FLAT
-62,35,73,108,74,158,92,107,8,-36,-70,-62,-132,-122,-72,-54,-151,-150,-166,-194,-86,-145,-146,-213,FLAT
-15,25,49,74,108,74,158,92,-62,-39,-5,-15,-54,-75,-75,-77,-194,-161,-77,-69,-213,-189,-171,-209,FLAT
-62,9,72,81,74,108,74,158,-15,-39,-46,-62,-77,-78,-51,-77,-69,-114,-121,-139,-209,-200,-123,-131,FLAT
-36,60,53,113,81,74,108,74,-62,-55,-87,-36,-77,-94,-133,-98,-139,-133,-138,-113,-131,-169,-208,-175,FLAT
-25,44,26,70,113,81,74,108,-36,-52,-9,-25,-98,-107,-96,-61,-113,-146,-142,-123,-175,-185,-147,-138,FLAT
-131,10,136,146,70,113,81,74,-25,-21,-97,-131,-61,-73,-106,-156,-123,-128,-193,-192,-138,-167,-239,-254,FLAT
42,60,7,67,146,70,113,81,-131,-87,-8,42,-156,-108,-105,-89,-192,-160,-114,-114,-254,-215,-201,-150,FLAT
-60,38,71,109,67,146,70,113,42,4,-38,-60,-89,-83,-46,-18,-114,-104,-143,-149,-150,-156,-152,-174,FLAT
32,74,16,90,109,67,146,70,-60,-23,-4,32,-18,-19,-42,-28,-149,-106,-50,14,-174,-127,-147,-117,FLAT
48,53,41,94,66,90,109,67,34,84,56,48,66,107,103,82,6,84,99,114,48,88,61,54,FLAT
30,68,9,77,94,66,90,109,48,-2,15,30,82,82,71,78,114,105,118,112,54,82,114,144,FLAT
-13,47,16,63,77,94,66,90,30,-6,8,-13,78,-8,23,17,112,76,79,65,144,99,126,99,FLAT
-7,18,61,79,63,77,94,66,-13,38,22,-7,17,32,30,-20,65,30,45,10,99,114,101,58,FLAT
62,101,0,101,79,63,77,94,-7,1,-21,62,-20,39,1,55,10,33,9,42,58,31,24,72,FLAT
15,49,27,76,101,79,63,77,62,42,67,15,55,43,46,77,42,81,68,70,72,75,76,57,FLAT
74,80,40,120,76,101,79,63,15,87,43,74,77,129,110,89,70,130,89,151,57,168,111,144,FLAT
-13,45,25,70,120,76,101,79,74,-28,22,-13,89,59,65,61,151,101,132,76,144,102,111,138,FLAT
10,35,40,75,70,120,76,101,-13,25,20,10,61,-3,42,-3,76,84,85,71,138,126,152,86,FLAT
67,76,20,96,75,70,120,76,10,47,26,67,-3,72,46,77,71,44,68,64,86,131,111,138,FLAT
28,72,56,128,96,75,70,120,67,64,32,28,77,111,58,95,64,136,78,105,138,108,100,92,FLAT
-69,167,71,238,500,128,96,75,-413,-475,-213,-69,-385,-467,-577,-482,-318,-403,-545,-454,-308,-356,-519,-387,FLAT
-198,80,205,285,238,500,128,96,-69,-64,-111,-198,-482,-539,-324,-267,-454,-531,-688,-680,-387,-467,-656,-652,FLAT
335,401,129,530,285,238,500,128,-198,259,14,335,-267,195,-97,137,-680,-280,-310,68,-652,-272,-674,-345,FLAT
-173,1,299,300,200,530,285,238,-113,-25,-125,-173,222,-116,114,-286,24,143,128,49,-45,79,17,-149,FLAT
97,123,63,186,300,200,530,285,-173,-139,-25,97,-286,-164,-150,-76,49,-255,89,-189,-149,4,103,146,FLAT
-182,26,185,211,186,300,200,530,97,-60,-85,-182,-76,-199,-110,-85,-189,-224,-235,-258,146,-315,4,-371,FLAT
205,234,43,277,211,186,300,200,-182,63,-3,205,-85,3,-88,23,-258,-136,-113,120,-371,-161,-238,-53,FLAT
26,75,94,169,277,211,186,300,205,77,185,26,23,140,182,231,120,80,97,49,-53,-59,72,146,FLAT
-280,149,280,429,169,277,211,186,26,-94,-354,-280,231,-17,-169,-254,49,46,-172,-49,146,-14,-257,-231,FLAT
-50,5,131,136,429,169,277,211,-280,-199,94,-50,-254,-293,-260,-330,-49,-216,-75,-304,-231,-153,-78,-99,FLAT
-26,42,55,97,166,109,136,429,90,6,75,-26,151,74,86,64,101,49,88,125,-179,-150,182,75,FLAT
139,142,19,161,97,166,109,136,-26,103,39,139,64,109,114,113,125,177,125,203,75,152,127,264,FLAT
22,72,11,83,161,97,166,109,139,14,92,22,113,117,131,161,203,123,206,135,264,191,217,225,FLAT
53,99,8,107,83,161,97,166,22,50,26,53,161,64,118,75,135,167,157,214,225,173,232,188,FLAT
-50,10,55,65,107,83,161,97,53,-3,39,-50,75,47,65,3,214,61,157,25,188,164,196,164,FLAT
9,52,18,70,65,107,83,161,-50,-28,-33,9,3,-31,6,-41,25,19,32,12,164,33,124,34,FLAT
16,22,17,39,70,65,107,83,9,15,46,16,-41,-13,13,25,12,-16,52,-25,34,34,78,28,FLAT
13,24,31,55,39,70,65,107,16,27,11,13,25,42,57,29,-25,14,24,38,28,11,63,-12,FLAT
32,32,6,38,37,42,50,45,14,24,23,32,55,52,56,46,98,86,98,87,109,103,110,130,FLAT
-20,2,28,30,38,37,42,50,32,2,10,-20,46,26,33,12,87,54,66,26,130,88,108,67,FLAT
21,29,0,29,30,38,37,42,-20,-7,-6,21,12,-5,4,1,26,19,27,33,67,47,60,47,FLAT
-19,3,26,29,29,30,38,37,21,7,7,-19,1,0,1,2,33,2,11,-18,47,26,34,14,FLAT
-5,13,14,27,29,29,30,38,-19,-17,-15,-5,2,-10,-8,-24,-18,-17,-14,-3,14,-15,-4,-23,FLAT
25,28,21,49,27,29,29,30,-5,32,10,25,-24,15,-5,20,-3,22,2,1,-23,15,-4,22,FLAT
-8,10,14,24,49,27,29,29,25,-15,10,-8,20,17,20,17,1,0,5,12,22,7,12,-7,FLAT
-27,18,44,62,37,24,49,27,-10,-7,-32,-27,-18,-7,-45,-37,7,-22,-35,-45,2,10,-25,-20,FLAT
-43,26,43,69,62,37,24,49,-27,-44,-51,-43,-37,-51,-83,-70,-45,-51,-96,-80,-20,-66,-86,-88,FLAT
-40,15,61,76,69,62,37,24,-43,-22,-29,-40,-70,-66,-80,-83,-80,-73,-112,-110,-88,-73,-125,-120,FLAT
50,56,37,93,76,69,62,37,-40,26,9,50,-83,4,-20,10,-110,-40,-71,-33,-120,-47,-103,-60,FLAT
88,102,14,116,93,76,69,62,50,65,42,88,10,91,51,138,-33,69,22,98,-60,25,-29,55,FLAT
-111,19,136,155,116,93,76,69,88,11,-28,-111,138,76,14,-23,98,102,23,27,55,80,-6,-13,FLAT
28,60,18,78,155,116,93,76,-111,-90,-13,28,-23,-79,-41,-83,27,-14,1,5,-13,12,10,55,FLAT
-37,15,84,99,78,155,116,93,28,29,8,-37,-83,-61,-5,-9,5,-50,-33,-120,55,15,9,-32,FLAT
13,39,27,66,133,99,78,155,-66,-81,-14,13,-103,-110,-77,-53,-75,-81,-69,-90,-186,-171,-82,-62,FLAT
-12,24,26,50,66,133,99,78,13,-13,3,-12,-53,-94,-11,1,-90,-123,-74,-65,-62,-94,-66,-102,FLAT
29,41,1,42,50,66,133,99,-12,4,12,29,1,-9,15,17,-65,-90,1,30,-102,-119,-62,-36,FLAT
-14,44,35,79,42,50,66,133,29,20,-17,-14,17,24,-5,15,30,11,-2,3,-36,-70,-16,16,FLAT
-3,61,3,64,79,42,50,66,-14,-35,-20,-3,15,-15,-37,-17,3,-11,-25,12,16,-24,-22,0,FLAT
-6,8,45,53,64,79,42,50,-3,36,47,-6,-17,1,27,-9,12,21,10,-23,0,25,22,6,FLAT
8,37,33,70,53,64,79,42,-6,-4,-21,8,-9,32,26,2,-23,-3,6,-1,6,17,-11,-15,FLAT
-8,26,31,57,70,53,64,79,8,-10,3,-8,2,-14,-18,0,-1,22,29,-6,-15,-13,9,-9,FLAT
19,46,5,51,57,70,53,64,-8,-7,-1,19,0,-17,2,11,-6,-21,-19,19,-9,15,28,13,FLAT
15,65,2,67,51,57,70,53,19,12,-4,15,11,5,-5,34,19,-5,-2,26,13,-9,-23,34,FLAT
-50,15,50,65,67,51,57,70,15,-2,0,-50,34,10,-4,-35,26,3,-5,-16,34,-7,-2,-24,FLAT
-10,32,20,52,45,65,67,51,-10,0,-7,-10,-60,-50,-37,-20,-45,-52,-37,-70,-26,-40,-41,-55,FLAT
-26,22,45,67,52,45,65,67,-10,-1,-16,-26,-20,-1,-23,-36,-70,-51,-53,-46,-55,-53,-53,-96,FLAT
-70,10,83,93,67,52,45,65,-26,-32,-58,-70,-36,-33,-74,-96,-46,-33,-81,-106,-96,-83,-111,-116,FLAT
-49,10,55,65,93,67,52,45,-70,-77,-49,-49,-96,-109,-107,-119,-106,-110,-123,-145,-116,-110,-130,-155,FLAT
35,56,21,77,65,93,67,52,-49,1,-11,35,-119,-76,-60,-14,-145,-108,-118,-84,-155,-109,-134,-110,FLAT
-4,19,62,81,77,65,93,67,35,37,33,-4,-14,38,22,31,-84,-39,-27,-18,-110,-71,-85,-88,FLAT
-402,33,411,444,81,77,65,93,-4,-53,-416,-402,31,-16,-383,-406,-18,-15,-394,-371,-88,-92,-443,-420,FLAT
38,92,112,204,444,81,77,65,-402,-261,-21,38,-406,-314,-437,-364,-371,-277,-404,-368,-420,-276,-415,-333,FLAT
-35,35,103,138,136,204,444,81,133,65,63,-35,171,89,155,98,-231,-172,134,136,-235,-225,-282,-266,FLAT
-24,48,101,149,138,136,204,444,-35,-26,-37,-24,98,39,26,-59,136,63,118,74,-266,-198,97,112,FLAT
80,108,31,139,149,138,136,204,-24,10,20,80,-59,-16,-17,56,74,49,46,21,112,73,138,154,FLAT
9,71,13,84,139,149,138,136,80,-9,46,9,56,1,66,89,21,-25,29,65,154,40,92,30,FLAT
134,141,23,164,84,139,149,138,9,144,64,134,89,135,110,143,65,145,130,223,30,119,93,199,FLAT
-47,28,55,83,164,84,139,149,134,-15,66,-47,143,129,130,87,223,120,176,96,199,130,196,176,FLAT
59,78,8,86,83,164,84,139,-47,12,9,59,87,-3,75,12,96,141,139,146,176,132,185,155,FLAT
129,151,13,164,86,83,164,84,59,134,56,129,12,146,65,188,146,131,131,141,155,275,195,275,FLAT
-9,35,38,73,164,86,83,164,129,16,107,-9,188,150,163,120,141,162,172,179,275,147,238,132,FLAT
15,64,17,81,73,164,86,83,-9,-6,-14,15,120,10,93,6,179,144,149,135,132,156,158,194,FLAT
43,56,21,77,81,73,164,86,15,47,51,43,6,41,37,58,135,57,144,49,194,191,200,178,FLAT
-20,0,56,56,77,81,73,164,43,15,36,-20,58,62,87,23,49,56,73,38,178,72,180,29,FLAT
-6,9,30,39,56,77,81,73,-20,-32,-15,-6,23,-17,21,-26,38,30,72,17,29,24,58,32,FLAT
46,46,3,49,39,56,77,81,-6,19,9,46,-26,-13,-6,40,17,2,30,20,32,49,81,63,FLAT
54,57,46,103,49,39,56,77,46,97,43,54,40,116,52,100,20,84,37,94,63,99,73,74,FLAT
2,26,24,50,103,49,39,56,54,-20,33,2,100,77,76,56,94,96,85,102,74,64,70,96,FLAT
-56,26,70,96,136,50,103,49,-116,-122,-82,-56,-114,-126,-172,-172,-60,-146,-139,-170,-14,-49,-96,-116,FLAT
-35,19,37,56,96,136,50,103,-56,-68,-28,-35,-172,-190,-110,-91,-170,-194,-200,-207,-116,-214,-167,-205,FLAT
2,13,9,22,29,29,45,54,18,8,15,2,32,15,22,20,68,41,64,34,29,28,60,70,FLAT
5,10,2,12,22,29,29,45,2,-2,8,5,20,6,23,7,34,13,30,25,70,39,72,39,FLAT
10,11,12,23,12,22,29,29,5,20,9,10,7,18,17,15,25,26,32,17,39,33,39,35,FLAT
18,20,3,23,23,12,22,29,10,9,9,18,15,29,18,28,17,27,26,33,35,35,41,35,FLAT
12,16,7,23,23,23,12,22,18,16,16,12,28,25,25,30,33,45,34,40,35,43,42,45,FLAT
-21,6,30,36,23,23,23,12,12,2,-11,-21,30,18,5,-9,40,27,14,9,45,47,23,19,FLAT
4,9,4,13,36,23,23,23,-21,-22,1,4,-9,-20,-10,-17,9,-4,6,-5,19,5,15,13,FLAT
-26,7,36,43,13,36,23,23,4,6,-24,-26,-17,-16,-23,-22,-5,-14,-34,-43,13,2,-18,-31,FLAT
-4,21,24,45,43,13,36,23,-26,-16,-18,-4,-22,-10,-42,-30,-43,-32,-41,-26,-31,-30,-52,-47,FLAT
74,89,1,90,45,43,13,36,-4,51,6,74,-30,35,-12,70,-26,41,-36,44,-47,19,-35,48,FLAT
-34,6,39,45,90,45,43,13,74,4,49,-34,70,55,55,40,44,39,37,36,48,45,13,10,FLAT
10,13,34,47,45,90,45,43,-34,5,3,10,40,9,52,-24,36,60,58,50,10,44,40,46,FLAT
45,58,22,80,47,45,90,45,10,33,0,45,-24,38,3,55,50,42,52,21,46,93,58,95,FLAT
-5,21,24,45,80,47,45,90,45,-3,32,-5,55,30,32,40,21,35,35,50,95,39,84,16,FLAT
-34,6,51,57,45,80,47,45,-5,-7,-19,-34,40,-10,13,-39,50,23,13,6,16,28,16,16,FLAT
-16,44,39,83,57,45,80,47,-34,-28,-54,-16,-39,-35,-73,-50,6,-38,-41,-55,16,-5,-41,-10,FLAT
65,70,6,76,83,57,45,80,-16,32,39,65,-50,4,-15,49,-55,-3,-34,15,-10,-6,-2,10,FLAT
-38,26,80,106,76,83,57,45,65,36,6,-38,49,68,45,27,15,40,-9,11,10,33,-28,-23,FLAT
43,61,27,88,106,76,83,57,-38,-10,8,43,27,26,14,5,11,58,53,70,-23,30,-1,54,FLAT
4,23,23,46,88,106,76,83,43,0,42,4,5,-10,50,47,70,26,56,9,54,58,95,74,FLAT
-142,1,177,178,46,88,106,76,4,12,-120,-142,47,12,-78,-138,9,2,-70,-95,74,38,-64,-133,FLAT
-81,5,90,95,178,46,88,106,-142,-168,-85,-81,-138,-156,-205,-223,-95,-156,-163,-219,-133,-166,-155,-176,FLAT
16,68,6,74,95,178,46,88,-81,-68,-47,16,-223,-236,-132,-65,-219,-224,-252,-207,-176,-224,-210,-203,FLAT
33,39,32,71,36,74,95,178,31,63,28,33,47,90,93,64,-34,22,46,80,-176,-146,-39,-1,FLAT
77,83,4,87,71,36,74,95,33,49,33,77,64,112,61,110,80,139,126,141,-1,71,79,157,FLAT
-5,34,18,52,87,71,36,74,77,9,44,-5,110,58,77,72,141,121,105,105,157,148,170,136,FLAT
29,45,24,69,52,87,71,36,-5,35,18,29,72,44,62,24,105,93,95,101,136,156,123,134,FLAT
19,24,22,46,69,52,87,71,29,17,40,19,24,52,58,48,101,61,102,43,134,110,135,120,FLAT
25,25,9,34,46,69,52,87,19,12,24,25,48,29,64,44,43,64,82,73,120,73,126,68,FLAT
-87,51,91,142,69,60,34,46,-20,-59,-132,-87,-66,-68,-150,-107,-41,-71,-179,-153,-22,-59,-155,-128,FLAT
-1,32,38,70,142,69,60,34,-87,-54,18,-1,-107,-113,-114,-88,-153,-122,-132,-108,-128,-125,-161,-154,FLAT
37,68,3,71,70,142,69,60,-1,2,1,37,-88,-52,19,36,-108,-111,-113,-51,-154,-120,-131,-71,FLAT
-8,44,17,61,71,70,142,69,37,6,16,-8,36,8,17,29,-51,-46,35,28,-71,-105,-97,-59,FLAT
-9,14,44,58,61,71,70,142,-8,18,21,-9,29,24,37,-17,28,26,38,20,-59,-28,56,19,FLAT
46,81,7,88,58,61,71,70,-9,9,-21,46,-17,27,0,37,20,33,16,29,19,35,17,66,FLAT
-40,18,47,65,88,58,61,71,46,0,23,-40,37,9,2,6,29,27,23,-3,66,33,39,-11,FLAT
19,19,48,67,65,88,58,61,-40,20,18,19,6,20,41,-21,-3,29,20,25,-11,47,41,16,FLAT
40,91,2,93,67,65,88,58,19,-6,-32,40,-21,14,-14,59,25,14,9,19,16,23,-12,65,FLAT
-63,11,70,81,135,93,67,65,-116,-115,-61,-63,-76,-111,-99,-179,-57,-117,-131,-139,-97,-97,-113,-120,FLAT
-34,7,52,59,81,135,93,67,-63,-52,-30,-34,-179,-167,-91,-97,-139,-163,-129,-213,-120,-169,-161,-173,FLAT
-63,29,71,100,59,81,135,93,-34,-44,-85,-63,-97,-96,-115,-97,-213,-211,-176,-160,-173,-207,-214,-276,FLAT
-22,22,40,62,100,59,81,135,-63,-53,-15,-22,-97,-97,-100,-85,-160,-149,-130,-119,-276,-264,-191,-182,FLAT
34,44,25,69,75,62,100,59,34,38,44,34,12,53,46,68,-51,0,31,46,-85,-44,-54,-17,FLAT
-9,7,39,46,69,75,62,100,34,5,28,-9,68,43,72,25,46,58,74,59,-17,5,59,37,FLAT
46,55,0,55,46,69,75,62,-9,7,-2,46,25,12,26,37,59,50,70,71,37,65,72,105,FLAT
24,26,19,45,55,46,69,75,46,43,53,24,37,50,51,70,71,55,79,61,105,93,123,95,FLAT
-1,14,26,40,45,55,46,69,24,6,11,-1,70,49,64,23,61,56,62,69,95,61,90,60,FLAT
7,27,4,31,40,45,55,46,-1,-15,-6,7,23,-9,5,6,69,34,58,30,60,41,56,76,FLAT
-2,17,22,39,31,40,45,55,7,16,8,-2,6,1,2,5,30,7,13,4,76,50,66,28,FLAT
-56,0,56,56,47,39,31,40,-34,-41,-50,-56,-36,-56,-73,-90,-29,-40,-65,-92,-30,-55,-71,-85,FLAT
-25,22,28,50,56,47,39,31,-56,-53,-47,-25,-90,-94,-97,-81,-92,-109,-120,-115,-85,-93,-112,-117,FLAT
35,41,3,44,20,32,25,23,9,27,3,35,0,27,15,44,-3,34,15,35,0,17,-4,32,FLAT
-8,3,24,27,44,20,32,25,35,13,30,-8,44,40,33,27,35,40,45,36,32,47,45,27,FLAT
-3,9,11,20,27,44,20,32,-8,-16,-9,-3,27,-3,21,-11,36,24,24,24,27,24,36,33,FLAT
6,13,11,24,20,27,44,20,-3,6,2,6,-11,-10,-7,3,24,3,23,-5,33,30,26,30,FLAT
-44,6,55,61,24,20,27,44,6,0,-37,-44,3,6,-35,-38,-5,-10,-44,-41,30,3,-14,-49,FLAT
-24,20,33,53,61,24,20,27,-44,-46,-38,-24,-38,-46,-75,-68,-41,-40,-73,-62,-49,-56,-82,-65,FLAT
57,58,4,62,53,61,24,20,-24,28,19,57,-68,-18,-19,33,-62,-18,-56,-11,-65,-12,-54,-5,FLAT
6,24,16,40,62,53,61,24,57,18,40,6,33,46,59,63,-11,0,21,39,-5,0,-16,-5,FLAT
15,37,1,38,40,62,53,61,6,0,2,15,63,18,42,21,39,46,61,78,-5,0,23,54,FLAT
8,45,17,62,38,40,62,53,15,24,0,8,21,24,2,23,78,42,42,29,54,70,61,86,FLAT
17,36,25,61,62,38,40,62,8,25,26,17,23,49,26,25,29,49,28,40,86,67,68,46,FLAT
0,5,41,46,61,62,38,40,17,16,31,0,25,41,57,17,40,65,57,25,46,65,59,40,FLAT
-26,69,31,100,46,61,62,38,0,-36,-90,-26,17,-20,-59,-26,25,5,-33,-9,40,29,-33,-1,FLAT
9,47,54,101,100,46,61,62,-26,32,31,9,-26,-4,-59,-17,-9,12,-28,-17,-1,37,-2,0,FLAT
-56,48,62,110,146,101,100,46,-119,-118,-82,-56,-110,-167,-176,-175,-136,-135,-145,-166,-136,-171,-235,-192,FLAT
6,29,5,34,110,146,101,100,-56,-51,25,6,-175,-169,-57,-50,-166,-218,-151,-169,-192,-186,-120,-160,FLAT
-7,12,88,100,34,110,146,101,6,76,10,-7,-50,25,35,-1,-169,-93,-47,-57,-160,-142,-141,-176,FLAT
-6,18,20,38,100,34,110,146,-7,-74,-12,-6,-1,2,-2,-13,-57,-49,23,-7,-176,-167,-59,-63,FLAT
14,34,18,52,38,100,34,110,-6,12,-2,14,-13,-62,-14,8,-7,14,-4,1,-63,-37,21,7,FLAT
6,49,12,61,52,38,100,34,14,0,-9,6,8,12,-11,20,1,-62,-23,14,7,14,-13,7,FLAT
22,24,34,58,61,52,38,100,6,44,47,22,20,44,38,28,14,56,36,42,7,-18,24,36,FLAT
22,55,4,59,58,61,52,38,22,-8,-9,22,28,36,38,44,42,36,29,50,36,48,27,64,FLAT
-34,17,36,53,59,58,61,52,22,-2,4,-34,44,-10,-5,-12,50,34,42,10,64,34,33,16,FLAT
42,44,0,44,53,59,58,61,-34,6,15,42,-12,4,19,8,10,-4,10,30,16,40,57,52,FLAT
-47,3,48,51,44,53,59,58,42,1,-6,-47,8,7,9,-5,30,5,13,-39,52,-3,4,-17,FLAT
30,39,20,59,51,44,53,59,-47,2,-6,30,-5,3,-12,-17,-39,9,3,25,-17,7,7,-9,FLAT
-26,24,29,53,59,51,44,53,30,-17,-11,-26,-17,-15,-17,4,25,-14,-23,-43,-9,-8,-8,-1,FLAT
0,11,32,43,53,59,51,44,-26,3,13,0,4,-14,2,-26,-43,-12,-4,4,-1,-11,-10,-43,FLAT
-91,12,91,103,50,40,43,53,-45,-46,-99,-91,-55,-85,-148,-136,-55,-87,-147,-146,-81,-84,-134,-146,FLAT
-15,47,17,64,103,50,40,43,-91,-89,-50,-15,-136,-135,-149,-106,-146,-174,-198,-151,-146,-176,-197,-161,FLAT
-20,32,31,63,64,103,50,40,-15,-6,-5,-20,-106,-95,-55,-35,-151,-141,-154,-126,-161,-180,-203,-171,FLAT
9,38,22,60,63,64,103,50,-20,0,3,9,-35,-6,-2,-11,-126,-95,-52,-26,-171,-141,-151,-117,FLAT
-4,33,50,83,60,63,64,103,9,24,1,-4,-11,24,4,5,-26,18,-1,-15,-117,-71,-51,-30,FLAT
-120,3,131,134,83,60,63,64,-4,-39,-90,-120,5,-15,-89,-124,-15,-15,-86,-115,-30,-21,-91,-135,FLAT
-29,40,55,95,134,83,60,63,-120,-105,-66,-29,-124,-144,-156,-149,-115,-120,-155,-153,-135,-120,-152,-144,FLAT
-7,55,17,72,95,134,83,60,-29,-45,-22,-7,-149,-150,-88,-36,-153,-189,-178,-156,-144,-165,-177,-160,FLAT
80,82,18,100,129,72,95,134,73,73,102,80,66,154,126,153,37,109,104,146,-83,4,38,117,FLAT
-69,0,83,83,100,129,72,95,80,-4,13,-69,153,69,115,11,146,150,139,84,117,105,117,77,FLAT
91,95,5,100,83,100,129,72,-69,13,-4,91,11,9,9,22,84,82,111,102,77,163,135,175,FLAT
-9,62,10,72,100,83,100,129,91,-4,24,-9,22,9,20,82,102,5,33,13,175,78,135,93,FLAT
-72,28,72,100,72,100,83,100,-9,-10,-38,-72,82,-14,-14,-81,13,-1,-18,10,93,-5,-5,-59,FLAT
6,20,38,58,100,72,100,83,-72,-28,14,6,-81,-38,-24,-66,10,-42,0,-75,-59,-29,-4,16,FLAT
8,35,6,41,58,100,72,100,6,-24,-7,8,-66,-52,7,14,-75,-62,-31,-58,16,-66,-7,-67,FLAT
-19,45,26,71,41,58,100,72,8,1,-29,-19,14,-23,-36,-11,-58,-51,-22,-5,-67,-61,-60,-77,FLAT
-27,5,38,43,71,41,58,100,-19,-15,13,-27,-11,-14,-16,-46,-5,-38,-23,-38,-77,-66,-9,-32,FLAT
27,63,7,70,43,71,41,58,-27,-4,-31,27,-46,-19,-18,0,-38,-18,-47,-19,-32,-42,-54,-11,FLAT
-31,23,46,69,62,70,43,71,33,-8,-15,-31,60,41,42,2,33,37,11,29,14,22,24,2,FLAT
-4,13,36,49,69,62,70,43,-31,-14,6,-4,2,-22,-9,-35,29,27,48,-2,2,23,17,25,FLAT
19,31,24,55,49,69,62,70,-4,7,1,19,-35,-7,7,15,-2,-15,-8,-16,25,34,49,17,FLAT
35,41,40,81,55,49,69,62,19,51,25,35,15,58,26,54,-16,44,32,50,17,36,17,19,FLAT
-5,9,24,33,81,55,49,69,35,-21,27,-5,54,30,52,30,50,37,53,49,19,23,59,45,FLAT
35,68,11,79,33,81,55,49,-5,22,-24,35,30,1,3,30,49,52,28,65,45,59,29,84,FLAT
-6,14,6,20,23,20,34,27,10,-5,-2,-6,20,9,9,4,25,7,21,14,38,19,26,19,FLAT
-10,7,12,19,20,23,20,34,-6,-4,-3,-10,4,-9,-5,-16,14,5,6,-6,19,3,18,4,FLAT
13,18,8,26,19,20,23,20,-10,9,2,13,-16,5,-1,3,-6,0,-3,-3,4,14,8,7,FLAT
-13,4,20,24,26,19,20,23,13,-1,1,-13,3,8,3,0,-3,4,0,-10,7,-1,-2,-16,FLAT
-19,6,23,29,35,24,26,19,-32,-29,-23,-19,-45,-48,-53,-51,-32,-49,-52,-64,-42,-40,-50,-51,FLAT
-40,2,45,47,29,35,24,26,-19,-18,-36,-40,-51,-47,-59,-59,-64,-66,-89,-91,-51,-67,-88,-104,FLAT
-5,33,15,48,47,29,35,24,-40,-35,-36,-5,-59,-53,-72,-45,-91,-82,-95,-64,-104,-101,-125,-96,FLAT
48,73,9,82,33,48,47,29,11,51,2,48,6,53,19,59,-34,18,-17,54,-53,0,-53,14,FLAT
-47,2,58,60,82,33,48,47,48,2,24,-47,59,53,26,1,54,55,43,12,14,20,7,7,FLAT
72,84,10,94,60,82,33,48,-47,24,-10,72,1,26,14,25,12,77,16,73,7,79,33,84,FLAT
-45,16,57,73,94,60,82,33,72,2,23,-45,25,26,13,27,73,28,37,-20,84,79,39,28,FLAT
71,81,44,125,73,94,60,82,-45,58,6,71,27,60,29,26,-20,84,19,98,28,86,43,51,FLAT
26,45,6,51,125,73,94,60,71,-12,62,26,26,46,68,97,98,48,91,52,51,72,81,124,FLAT
-37,6,71,77,51,125,73,94,26,28,2,-37,97,16,64,-11,52,74,70,60,124,76,93,15,FLAT
-70,77,70,147,129,77,51,125,-107,-107,-125,-70,-144,-178,-248,-177,-118,-150,-246,-214,-47,-162,-184,-188,FLAT
-3,6,39,45,147,129,77,51,-70,-34,68,-3,-177,-141,-57,-73,-214,-212,-180,-180,-188,-184,-178,-217,FLAT
-23,12,39,51,45,147,129,77,-3,-23,-29,-23,-73,-57,39,-26,-180,-164,-86,-96,-217,-235,-209,-203,FLAT
-33,8,58,66,51,45,147,129,-23,-14,-29,-33,-26,-37,-58,-56,-96,-71,10,-59,-203,-178,-115,-129,FLAT
-30,11,54,65,66,51,45,147,-33,-34,-33,-30,-56,-48,-62,-63,-59,-71,-91,-86,-129,-105,-23,-89,FLAT
58,58,4,62,65,66,51,45,-30,8,11,58,-63,-26,-22,28,-86,-40,-51,-5,-89,-63,-80,-28,FLAT
2,22,14,36,62,65,66,51,58,12,38,2,28,20,49,60,-5,-14,16,30,-28,-28,-13,-3,FLAT
17,29,25,54,36,62,65,66,2,28,10,17,60,40,48,19,30,48,59,77,-3,14,26,47,FLAT
17,27,24,51,54,36,62,65,17,16,19,17,19,44,29,34,77,56,67,36,47,64,78,94,FLAT
-28,7,39,46,51,54,36,62,17,-13,-8,-28,34,3,11,-11,36,31,21,6,94,43,59,8,FLAT
-12,29,16,45,46,51,54,36,-28,-35,-34,-12,-11,-48,-42,-40,6,-32,-23,-23,8,-4,-13,-6,FLAT
4,24,8,32,45,46,51,54,-12,-4,9,4,-40,-39,-25,-8,-23,-52,-33,-36,-6,-36,-14,-19,FLAT
-77,10,79,89,32,45,46,51,4,-6,-63,-77,-8,-10,-54,-73,-36,-45,-88,-85,-19,-58,-96,-113,FLAT
23,35,8,43,89,32,45,46,-77,-48,-2,23,-73,-54,-65,-54,-85,-58,-56,-50,-113,-93,-90,-62,FLAT
-21,5,38,43,55,43,89,32,20,9,21,-21,43,29,29,-1,-34,-19,27,22,-30,-25,-36,-55,FLAT
4,26,17,43,43,55,43,89,-21,-17,-17,4,-1,-8,4,-17,22,12,12,3,-55,-36,10,26,FLAT
-36,46,47,93,43,43,55,43,4,-6,-56,-36,-17,-23,-73,-32,3,-14,-52,-53,26,6,-44,-33,FLAT
480,481,28,509,93,43,43,55,-36,461,45,480,-32,455,-11,444,-53,438,-28,448,-33,447,-7,427,FLAT
68,144,49,193,509,93,43,43,480,89,405,68,444,550,450,548,448,544,394,512,427,527,377,516,FLAT
-21,91,76,167,193,509,93,43,68,6,32,-21,548,95,437,47,512,556,482,527,516,550,426,491,FLAT
-74,43,111,154,212,167,193,509,-149,-114,-56,-74,-170,-188,-175,-223,-102,-182,-143,-244,378,-93,262,-176,FLAT
97,97,31,128,154,212,167,193,-74,17,43,97,-223,-97,-13,23,-244,-171,-132,-126,-176,-165,-100,-147,FLAT
-8,27,87,114,128,154,212,167,97,48,62,-8,23,65,105,89,-126,-49,49,15,-147,-123,-70,-134,FLAT
17,37,200,237,114,128,154,212,-8,130,7,17,89,178,69,9,15,195,112,106,-134,81,56,32,FLAT
-121,7,129,136,237,114,128,154,17,-192,-91,-121,9,-62,-84,-104,106,-14,-22,-112,32,3,21,-15,FLAT
-28,81,28,109,136,237,114,128,-121,-129,-102,-28,-104,-321,-193,-149,-112,-191,-186,-132,-15,-143,-124,-140,FLAT
26,38,45,83,109,136,237,114,-28,43,69,26,-149,-86,-33,-2,-132,-278,-124,-123,-140,-148,-117,-106,FLAT
8,25,44,69,83,109,136,237,26,7,21,8,-2,50,90,34,-123,-79,-12,6,-106,-271,-103,-115,FLAT
-17,51,44,95,69,83,109,136,8,-17,-43,-17,34,-10,-22,-9,6,33,47,17,-115,-96,-55,-11,FLAT
-86,0,95,95,95,69,83,109,-17,-35,-35,-86,-9,-52,-78,-103,17,-45,-57,-95,-11,-2,12,-69,FLAT
41,44,14,58,95,95,69,83,-86,-40,-3,41,-103,-75,-38,-45,-95,-92,-81,-62,-69,-85,-60,-54,FLAT
30,56,12,68,58,95,95,69,41,28,18,30,-45,-12,15,71,-62,-47,-20,-15,-54,-64,-63,-32,FLAT
-1,10,31,41,68,58,95,95,30,18,45,-1,71,46,63,29,-15,6,60,70,-32,-29,25,-16,FLAT
-19,12,37,49,41,68,58,95,-1,-13,-21,-19,29,5,24,-20,70,33,42,10,-16,-7,39,51,FLAT
-9,20,33,53,49,41,68,58,-19,-13,-17,-9,-20,-26,-38,-28,10,-8,7,-29,51,20,25,1,FLAT
-35,17,51,68,53,49,41,68,-9,-17,-32,-35,-28,-30,-49,-44,-29,-43,-70,-63,1,-25,-25,-64,FLAT
-21,23,29,52,68,53,49,41,-35,-43,-27,-21,-44,-60,-59,-56,-63,-73,-76,-65,-64,-86,-97,-84,FLAT
-12,9,14,23,42,24,35,63,-26,-24,-5,-12,-40,-41,-40,-38,-49,-59,-47,-52,-8,-56,-16,-61,FLAT
-30,19,33,52,23,42,24,35,-12,-11,-40,-30,-38,-35,-45,-42,-52,-52,-80,-68,-61,-70,-87,-82,FLAT
9,11,15,26,52,23,42,24,-30,-9,17,9,-42,-20,-23,-21,-68,-44,-28,-33,-82,-61,-63,-59,FLAT
6,14,10,24,38,26,52,23,24,13,27,6,33,25,27,30,3,16,44,39,-9,5,4,9,FLAT
20,30,0,30,24,38,26,52,6,10,4,20,30,23,31,26,39,35,31,50,9,26,48,59,FLAT
10,16,10,26,30,24,38,26,20,20,24,10,26,30,28,30,50,43,55,36,59,55,55,60,FLAT
26,33,14,47,26,30,24,38,10,30,9,26,30,50,33,36,36,60,37,56,60,73,64,62,FLAT
-27,8,41,49,47,26,30,24,26,0,-2,-27,36,30,7,-1,56,50,31,9,62,60,35,29,FLAT
-47,22,55,77,63,49,47,26,-43,-44,-58,-47,-70,-76,-104,-90,-44,-76,-106,-117,-34,-46,-97,-91,FLAT
-153,112,154,266,77,63,49,47,-47,-54,-243,-153,-90,-98,-301,-200,-117,-130,-347,-243,-91,-130,-349,-270,FLAT
-234,14,239,253,266,77,63,49,-153,-149,-136,-234,-200,-203,-379,-387,-243,-247,-437,-434,-270,-279,-483,-477,FLAT
22,86,32,118,253,266,77,63,-234,-185,-50,22,-387,-334,-186,-212,-434,-388,-429,-365,-477,-432,-487,-412,FLAT
-24,62,31,93,118,253,266,77,22,-25,0,-24,-212,-210,-50,-2,-365,-359,-186,-236,-412,-413,-429,-389,FLAT
23,50,26,76,93,118,253,266,-24,18,35,23,-2,-7,35,-1,-236,-192,-15,21,-389,-341,-151,-213,FLAT
-26,3,87,90,76,93,118,253,23,35,21,-26,-1,53,56,-3,21,28,56,-27,-213,-157,6,-5,FLAT
-25,93,91,184,90,76,93,118,-26,-21,-115,-25,-3,14,-94,-51,-27,32,-59,-28,-5,7,-59,-52,FLAT
54,95,17,112,184,90,76,93,-25,-20,52,54,-51,-41,-63,29,-28,-6,-42,3,-52,12,-7,26,FLAT
-3,69,5,74,112,184,90,76,54,-15,23,-3,29,-35,75,51,3,-56,-40,26,26,-21,-19,0,FLAT
-44,0,51,51,74,112,184,90,-3,2,25,-44,51,-13,48,-47,26,-33,100,7,0,-54,-15,-18,FLAT
0,1,62,63,51,74,112,184,-44,11,-1,0,-47,13,24,-44,7,-2,47,-47,-18,-22,99,7,FLAT
11,37,24,61,63,51,74,112,0,-27,-25,11,-44,-16,-26,11,-47,-14,-1,-33,7,-29,22,-36,FLAT
-20,36,35,71,61,63,51,74,11,-9,-19,-20,11,-36,-44,-9,-33,-25,-45,-9,-36,-23,-20,-53,FLAT
3,38,29,67,71,61,63,51,-20,-3,1,3,-9,-12,-18,-17,-9,-39,-43,-6,-53,-28,-44,-6,FLAT
-53,21,86,107,67,71,61,63,3,4,-36,-53,-17,1,-35,-50,-6,-8,-54,-70,-6,-35,-79,-59,FLAT
-24,2,68,70,107,67,71,61,-53,-42,-5,-24,-50,-38,-41,-77,-70,-41,-40,-74,-59,-50,-59,-94,FLAT
41,62,3,65,70,107,67,71,-24,-24,-19,41,-77,-66,-24,17,-74,-62,-60,-36,-94,-65,-59,-33,FLAT
-16,6,35,41,65,70,107,67,41,16,40,-16,17,-8,21,25,-36,-50,16,1,-33,-46,-20,-52,FLAT
68,79,11,90,41,65,70,107,-16,44,-5,68,25,60,35,52,1,36,16,93,-52,-6,11,69,FLAT
46,88,9,97,90,41,65,70,68,44,37,46,52,88,32,114,93,104,72,98,69,80,53,139,FLAT
-56,26,102,128,97,90,41,65,46,37,6,-56,114,81,43,-10,98,125,38,58,139,141,78,42,FLAT
33,68,7,75,128,97,90,41,-56,-62,-9,33,-10,-25,-3,-23,58,19,34,23,42,63,29,91,FLAT
6,43,19,62,75,128,97,90,33,18,31,6,-23,-44,22,39,23,-7,28,-17,91,37,65,29,FLAT
-10,52,53,105,62,75,128,97,6,24,-19,-10,39,42,12,-4,-17,-20,3,29,29,17,9,-27,FLAT
55,56,116,172,105,62,75,128,-10,118,51,55,-4,142,32,45,29,160,63,51,-27,98,54,84,FLAT
-71,58,71,129,123,118,172,105,-73,-77,-83,-71,-111,-176,-187,-144,-56,-227,-184,-182,-66,-109,-133,-127,FLAT
-95,4,114,118,129,123,118,172,-71,-52,-41,-95,-144,-129,-124,-166,-182,-228,-228,-239,-127,-279,-225,-277,FLAT
-73,8,80,88,118,129,123,118,-95,-107,-77,-73,-166,-159,-118,-168,-239,-236,-201,-239,-277,-335,-305,-312,FLAT
76,91,5,96,88,118,129,123,-73,1,-7,76,-168,-106,-84,3,-239,-158,-125,-92,-312,-235,-208,-163,FLAT
-3,61,26,87,96,88,118,129,76,18,27,-3,3,19,20,73,-92,-88,-57,0,-163,-140,-98,-95,FLAT
65,77,31,108,87,96,88,118,-3,70,49,65,73,88,76,62,0,89,69,138,-95,-18,-8,65,FLAT
22,37,36,73,108,87,96,88,65,27,62,22,62,97,111,87,138,115,138,84,65,116,131,160,FLAT
-18,34,39,73,73,108,87,96,22,-15,-15,-18,87,12,47,4,84,82,96,69,160,100,123,66,FLAT
16,21,27,48,73,73,108,87,-18,4,29,16,4,-11,14,-2,69,16,76,20,66,86,125,85,FLAT
-66,14,68,82,48,73,73,108,16,-25,-59,-66,-2,-21,-30,-50,20,-36,-45,-68,85,-9,17,-46,FLAT
48,56,16,72,82,48,73,73,-66,-4,6,48,-50,-29,-53,-18,-68,-25,-24,-2,-46,-40,-39,-20,FLAT
82,83,2,85,72,82,48,73,48,68,55,82,-18,64,61,130,-2,39,2,64,-20,43,31,80,FLAT
32,48,13,61,85,72,82,48,82,43,67,32,130,111,122,114,64,107,128,162,80,82,69,96,FLAT
3,14,14,28,61,85,72,82,32,4,37,3,114,47,104,35,162,115,159,117,96,111,165,165,FLAT
-23,15,40,55,28,61,85,72,3,3,-24,-23,35,7,13,-20,117,50,80,12,165,118,135,94,FLAT
-27,2,43,45,71,55,28,61,-64,-55,-29,-27,-87,-88,-78,-91,-84,-85,-102,-114,-52,-81,-65,-111,FLAT
-17,1,33,34,45,71,55,28,-27,-27,-16,-17,-91,-82,-45,-44,-114,-115,-94,-108,-111,-112,-118,-131,FLAT
-15,20,20,40,34,45,71,55,-17,-28,-34,-15,-44,-55,-50,-32,-108,-110,-79,-59,-131,-143,-128,-123,FLAT
29,37,3,40,25,26,44,33,-6,23,8,29,-2,22,8,23,7,30,34,27,-12,15,8,36,FLAT
29,34,5,39,40,25,26,44,29,31,32,29,23,54,40,58,27,53,40,52,36,61,66,56,FLAT
-12,3,17,20,39,40,25,26,29,0,19,-12,58,31,51,17,52,54,59,46,56,53,59,40,FLAT
9,17,6,23,20,39,40,25,-12,-2,-5,9,17,-2,14,-3,46,29,46,26,40,52,54,55,FLAT
15,24,8,32,23,20,39,40,9,17,8,15,-3,15,3,24,26,15,22,12,55,46,54,41,FLAT
-27,17,27,44,32,23,20,39,15,-8,-20,-27,24,9,-12,-12,12,7,-17,-3,41,7,2,-15,FLAT
46,52,1,53,44,32,23,20,-27,20,11,46,-12,12,-9,19,-3,29,-1,34,-15,27,-6,43,FLAT
-2,11,12,23,53,44,32,23,46,9,39,-2,19,29,50,44,34,21,30,17,43,38,38,32,FLAT
-38,5,64,69,23,53,44,32,-2,14,-32,-38,44,23,7,-40,17,43,18,6,32,35,-2,-21,FLAT
-3,43,21,64,69,23,53,44,-38,-46,-41,-3,-40,-32,-73,-41,6,-23,-34,-43,-21,-3,-23,3,FLAT
29,33,25,58,64,69,23,53,-3,33,39,29,-41,-13,-2,26,-43,1,-34,-12,3,10,5,-14,FLAT
31,51,19,70,58,64,69,23,29,25,13,31,26,58,52,60,-12,12,11,57,-14,26,-21,19,FLAT
-9,8,56,64,70,58,64,69,31,28,34,-9,60,53,47,22,57,86,86,51,19,40,45,48,FLAT
20,42,23,65,64,70,58,64,-9,-13,-14,20,22,15,20,11,51,40,33,42,48,73,72,71,FLAT
-20,1,67,68,65,64,70,58,20,24,21,-20,11,11,7,0,42,39,41,-9,71,64,54,22,FLAT
19,53,26,79,68,65,64,70,-20,-22,-33,19,0,2,-12,-1,-9,-11,-26,19,22,17,8,10,FLAT
-2,29,40,69,255,79,68,65,-232,-203,-17,-2,-213,-220,-210,-234,-233,-242,-243,-215,-213,-218,-222,-235,FLAT
34,43,25,68,69,255,79,68,-2,19,20,34,-234,-184,3,32,-215,-201,-190,-200,-235,-223,-223,-181,FLAT
-20,9,38,47,68,69,255,79,34,-7,14,-20,32,12,34,14,-200,-191,17,12,-181,-208,-176,-220,FLAT
47,56,6,62,47,68,69,255,-20,15,0,47,14,8,14,27,12,27,34,61,-220,-176,17,59,FLAT
-52,0,90,90,62,47,68,69,47,32,4,-52,27,47,4,-5,61,40,18,-25,59,59,38,9,FLAT
0,94,3,97,90,62,47,68,-52,-87,-94,0,-5,-55,-90,-52,-25,-40,-90,-5,9,-47,-76,-25,FLAT
-42,14,52,66,97,90,62,47,0,7,38,-42,-52,-80,-56,-42,-5,-48,-52,-94,-25,-33,-52,-47,FLAT
67,70,2,72,66,97,90,62,-42,17,11,67,-42,24,49,25,-94,-63,-45,25,-47,-31,-41,-27,FLAT
3,25,22,47,72,66,97,90,67,23,48,3,25,40,59,70,25,47,97,28,-27,-40,3,28,FLAT
4,19,33,52,47,72,66,97,3,15,10,4,70,38,58,7,28,55,69,74,28,62,107,32,FLAT
-36,5,55,60,52,47,72,66,4,-14,-22,-36,7,1,-12,-32,74,24,36,-29,32,41,47,38,FLAT
-25,1,54,55,60,52,47,72,-36,-26,-21,-25,-32,-40,-43,-61,-29,-25,-33,-57,38,-2,15,-54,FLAT
-18,9,22,31,55,60,52,47,-25,-50,-26,-18,-61,-76,-47,-43,-57,-90,-69,-79,-54,-75,-59,-75,FLAT
-131,5,131,136,31,55,60,52,-18,-22,-127,-131,-43,-72,-153,-149,-79,-98,-174,-174,-75,-112,-196,-210,FLAT
44,59,1,60,136,31,55,60,-131,-86,-10,44,-149,-108,-137,-87,-174,-158,-163,-105,-210,-184,-184,-130,FLAT
-29,17,45,62,60,136,31,55,44,15,13,-29,-87,-71,3,15,-105,-93,-124,-116,-130,-143,-150,-134,FLAT
-25,28,56,84,62,60,136,31,-29,-14,-36,-25,15,1,-23,-54,-116,-85,-33,-10,-134,-107,-160,-141,FLAT
-11,14,29,43,84,62,60,136,-25,-38,3,-11,-54,-52,-33,-36,-10,-37,-20,-65,-141,-123,-30,-21,FLAT
-9,64,23,87,43,84,62,60,-11,-15,-59,-9,-36,-53,-56,-20,-65,-67,-92,-45,-21,-52,-79,-74,FLAT
-6,29,29,58,87,43,84,62,-9,0,29,-6,-20,-15,-30,-15,-45,-53,-27,-26,-74,-67,-63,-51,FLAT
35,44,40,84,58,87,43,84,-6,46,20,35,-15,46,49,29,-26,31,-10,20,-51,-7,-7,9,FLAT
-11,63,27,90,84,58,87,43,35,-24,-30,-11,29,22,-10,24,20,22,19,18,9,7,-40,9,FLAT
-85,17,87,104,90,84,58,87,-11,-25,-39,-85,24,-49,-69,-96,18,-3,-49,-61,9,-3,-20,-67,FLAT
83,84,26,110,104,90,84,58,-85,22,16,83,-96,-3,-23,-2,-61,-27,-53,-13,-67,19,-33,22,FLAT
-16,77,100,177,110,104,90,84,83,58,-9,-16,-2,80,7,67,-13,55,-32,-18,22,31,-62,-29,FLAT
-63,46,65,111,177,110,104,90,-16,-98,-32,-63,67,-40,-41,-79,-18,-18,-25,4,-29,-43,-64,-81,FLAT
-71,7,73,80,111,177,110,104,-63,-63,-32,-71,-79,-161,-64,-134,4,-103,-73,-150,-81,-81,-57,-67,FLAT
-118,8,135,143,80,111,177,110,-71,-56,-119,-118,-134,-119,-151,-189,-150,-217,-183,-252,-67,-159,-192,-268,FLAT
-26,6,53,59,143,80,111,177,-118,-108,-24,-26,-189,-164,-143,-144,-252,-227,-175,-215,-268,-325,-207,-278,FLAT
16,51,10,61,59,143,80,111,-26,-27,-29,16,-144,-135,-53,-10,-215,-191,-172,-128,-278,-254,-204,-199,FLAT
-14,18,33,51,61,59,143,80,16,9,19,-14,-10,-18,-10,2,-128,-126,-34,-24,-199,-182,-153,-142,FLAT
-43,14,48,62,51,61,59,143,-14,-28,-39,-43,2,-19,-20,-57,-24,-46,-49,-41,-142,-154,-73,-67,FLAT
-8,14,22,36,62,51,61,59,-43,-34,-8,-8,-57,-62,-47,-51,-41,-53,-28,-65,-67,-80,-57,-49,FLAT
-32,7,41,48,36,62,51,61,-8,-13,-25,-32,-51,-47,-33,-40,-65,-75,-72,-83,-49,-66,-53,-97,FLAT
-29,3,50,53,48,36,62,51,-32,-20,-25,-29,-40,-33,-50,-61,-83,-67,-58,-69,-97,-95,-97,-112,FLAT
31,31,9,40,53,48,36,62,-29,-10,3,31,-61,-30,-22,2,-69,-43,-47,-30,-112,-77,-55,-38,FLAT
12,28,32,60,40,53,48,36,31,35,15,12,2,25,18,43,-30,5,-7,14,-38,-8,-32,-18,FLAT
33,45,6,51,60,40,53,48,12,7,16,33,43,42,31,45,14,32,34,76,-18,12,9,47,FLAT
-27,17,28,45,51,60,40,53,33,-5,1,-27,45,2,17,6,76,37,32,18,47,27,35,49,FLAT
9,19,12,31,45,51,60,40,-27,-7,7,9,6,-12,8,-18,18,-5,24,15,49,30,39,27,FLAT
0,15,7,22,25,20,55,31,-6,-16,-13,0,5,-2,-4,-6,46,3,36,5,29,22,31,46,FLAT
-20,2,24,26,22,25,20,55,0,-3,-7,-20,-6,-19,-20,-20,5,-5,-11,-26,46,0,29,-15,FLAT
35,42,4,46,26,22,25,20,-20,15,-5,35,-20,12,-12,15,-26,-4,-25,15,-15,10,-16,9,FLAT
0,6,10,16,46,26,22,25,35,6,36,0,15,21,31,35,15,18,24,15,9,2,11,15,FLAT
17,49,4,53,16,46,26,22,0,11,-26,17,35,17,10,17,15,32,5,52,15,29,-2,32,FLAT
12,26,1,27,53,16,46,26,17,9,35,12,17,20,9,29,52,26,45,29,32,41,40,64,FLAT
19,19,12,31,27,53,16,46,12,30,26,19,29,39,61,31,29,50,35,48,64,56,71,48,FLAT
6,27,7,34,31,27,53,16,19,1,-2,6,31,31,24,25,48,40,59,37,48,51,33,54,FLAT
8,18,17,35,34,31,27,53,6,18,17,8,25,19,15,14,37,49,41,33,54,58,76,45,FLAT
42,66,0,66,35,34,31,27,8,25,-6,42,14,43,11,50,33,44,9,56,45,74,35,75,FLAT
-65,2,67,69,66,35,34,31,42,2,-1,-65,50,27,-7,-23,56,45,10,-15,75,46,8,-9,FLAT
-27,26,38,64,69,66,35,34,-65,-56,-51,-27,-23,-54,-52,-92,-15,-29,-58,-50,-9,-11,-41,-42,FLAT
70,82,7,89,64,69,66,35,-27,39,14,70,-92,-17,-37,43,-50,-15,-38,-22,-42,10,-44,20,FLAT
-14,30,38,68,89,64,69,66,70,17,38,-14,43,56,52,56,-22,0,1,29,20,2,0,-36,FLAT
37,75,1,76,68,89,64,69,-14,0,-8,37,56,17,30,23,29,56,44,93,-36,0,-7,66,FLAT
36,47,16,63,76,68,89,64,37,51,64,36,23,51,56,73,93,68,94,59,66,107,108,129,FLAT
-17,17,26,43,63,76,68,89,36,-7,13,-17,73,44,77,19,59,44,69,56,129,61,107,42,FLAT
52,78,0,78,43,63,76,68,-17,26,-9,52,19,19,4,35,56,70,68,71,42,70,60,108,FLAT
-43,15,54,69,78,43,63,76,52,11,20,-43,35,37,11,9,71,30,24,-8,108,81,88,28,FLAT
-61,25,71,96,52,69,78,43,-2,-26,-70,-61,-45,-46,-73,-63,7,-35,-53,-106,-10,-9,-62,-54,FLAT
-107,24,108,132,96,52,69,78,-61,-70,-106,-107,-63,-96,-176,-168,-106,-116,-179,-170,-54,-105,-159,-213,FLAT
20,31,21,52,132,96,52,69,-107,-67,13,20,-168,-137,-93,-87,-170,-163,-163,-148,-213,-183,-166,-150,FLAT
21,42,9,51,71,52,132,96,70,29,49,21,90,79,80,91,-17,12,93,111,-78,-58,-13,4,FLAT
21,24,14,38,51,71,52,132,21,26,39,21,91,55,88,42,111,105,119,112,4,38,132,132,FLAT
28,70,4,74,38,51,71,52,21,18,-18,28,42,44,21,49,112,73,70,70,132,123,101,140,FLAT
9,29,8,37,74,38,51,71,28,13,50,9,49,31,32,37,70,57,71,58,140,86,120,79,FLAT
33,41,13,54,37,74,38,51,9,38,21,33,37,51,71,42,58,69,53,70,79,95,92,91,FLAT
-35,8,46,54,54,37,74,38,33,-2,-2,-35,42,36,19,-2,70,49,69,7,91,67,51,35,FLAT
28,30,13,43,54,54,37,74,-35,-5,6,28,-2,-7,4,-7,7,31,25,26,35,44,75,35,FLAT
10,48,8,56,43,54,54,37,28,5,-8,10,-7,0,-2,38,26,-2,-4,3,35,36,17,36,FLAT
-7,34,31,65,56,43,54,54,10,16,7,-7,38,21,-1,3,3,16,5,31,36,14,3,-4,FLAT
-37,0,56,56,65,56,43,54,-7,-12,-3,-37,3,4,4,-44,31,9,-4,-34,-4,4,2,-6,FLAT
34,34,10,44,56,65,56,43,-37,-12,0,34,-44,-24,-3,-3,-34,-8,4,-10,-6,-3,-4,0,FLAT
-5,32,141,173,44,56,65,56,34,126,-3,-5,-3,114,-3,29,-10,102,-6,-8,0,118,1,-15,FLAT
23,49,24,73,173,44,56,65,-5,-94,6,23,29,32,3,18,-8,20,3,52,-15,8,0,15,FLAT
-12,40,16,56,73,173,44,56,23,-20,-3,-12,18,-114,3,11,52,12,0,6,15,0,0,40,FLAT
12,31,22,53,56,73,173,44,-12,18,21,12,11,-2,18,0,6,-96,24,23,40,30,21,18,FLAT
-5,60,9,69,53,56,73,173,12,-18,-34,-5,0,0,-13,7,23,-20,-16,-5,18,-114,-10,18,FLAT
8,21,26,47,69,53,56,73,-5,25,47,8,7,7,13,3,-5,25,34,15,18,5,31,3,FLAT
-44,10,68,78,47,69,53,56,8,-2,-33,-44,3,23,14,-36,15,5,-20,-41,3,23,1,-29,FLAT
-22,51,45,96,78,47,69,53,-44,-45,-63,-22,-36,-47,-96,-66,-41,-22,-49,-58,-29,-40,-83,-63,FLAT
16,27,24,51,96,78,47,69,-22,-5,40,16,-66,-50,-23,-6,-58,-52,-56,-50,-63,-27,-9,-42,FLAT
-96,3,102,105,51,96,78,47,16,-18,-72,-96,-6,-23,-32,-80,-50,-68,-95,-102,-42,-70,-128,-146,FLAT
61,69,12,81,105,51,96,78,-96,-29,-5,61,-80,-47,-77,-35,-102,-52,-37,-19,-146,-97,-100,-41,FLAT
-5,7,35,42,81,105,51,96,61,18,57,-5,-35,-11,52,56,-19,-29,-20,-40,-41,-34,20,-24,FLAT
23,32,21,53,42,81,105,51,-5,9,-2,23,56,27,55,18,-40,-2,50,79,-24,-20,-22,-17,FLAT
6,9,21,30,53,42,81,105,23,6,29,6,18,15,27,29,79,33,84,24,-17,4,79,85,FLAT
-40,16,57,73,30,53,42,81,6,-4,-47,-40,29,2,-18,-34,24,11,-20,-11,85,29,37,-16,FLAT
15,23,10,33,73,30,53,42,-40,-32,8,15,-34,-36,-39,-25,-11,-30,-10,-19,-16,-21,-12,4,FLAT
-10,9,20,29,33,73,30,53,15,0,4,-10,-25,-32,12,5,-19,-36,-35,-35,4,-30,-6,-29,FLAT
92,100,1,101,29,33,73,30,-10,73,1,92,5,73,5,82,-35,41,13,97,-29,37,-34,57,FLAT
-18,18,19,37,101,29,33,73,92,0,64,-18,82,73,65,74,97,73,69,64,57,41,77,79,FLAT
6,9,12,21,37,101,29,33,-18,-1,15,6,74,-1,79,-12,64,72,80,80,79,72,84,70,FLAT
-11,15,19,34,21,37,101,29,6,-4,-17,-11,-12,-5,-2,-5,80,-5,62,-23,70,68,63,69,FLAT
0,2,11,13,24,48,17,35,21,10,21,0,-19,-9,26,21,-9,-10,-6,-19,9,0,22,-9,FLAT
-17,5,18,23,13,24,48,17,0,-10,-20,-17,21,0,1,-17,-19,-19,6,4,-9,-20,-26,-36,FLAT
2,10,9,19,23,13,24,48,-17,-7,-3,2,-17,-17,-23,-15,4,-7,-2,-15,-36,-26,3,6,FLAT
17,19,4,23,19,23,13,24,2,12,8,17,-15,5,5,19,-15,-5,-15,2,6,5,6,2,FLAT
2,6,5,11,23,19,23,13,17,3,15,2,19,15,23,19,2,8,20,21,2,-2,0,4,FLAT
10,19,7,26,56,11,23,19,-47,-31,-1,10,-45,-35,-50,-37,-28,-32,-35,-35,-26,-20,-27,-18,FLAT
-59,33,59,92,26,56,11,23,10,-7,-73,-59,-37,-38,-74,-49,-35,-42,-123,-96,-18,-39,-108,-94,FLAT
-23,5,51,56,92,26,56,11,-59,-31,5,-23,-49,-38,-68,-82,-96,-69,-69,-72,-94,-73,-118,-119,FLAT
-35,29,54,83,56,92,26,56,-23,-32,-59,-35,-82,-63,-54,-58,-72,-70,-127,-117,-119,-101,-128,-107,FLAT
-23,24,38,62,83,56,92,26,-35,-39,-18,-23,-58,-71,-77,-58,-117,-102,-72,-81,-107,-109,-145,-140,FLAT
51,61,6,67,63,62,83,56,61,57,53,51,38,80,75,112,3,41,57,89,-20,9,-2,54,FLAT
64,109,6,115,67,63,62,83,51,64,16,64,112,121,69,115,89,144,91,176,54,105,73,153,FLAT
-52,7,56,63,115,67,63,62,64,-2,50,-52,115,62,66,12,176,119,119,63,153,142,141,124,FLAT
66,72,41,113,63,115,67,63,-52,51,1,66,12,49,51,14,63,113,67,78,124,170,120,129,FLAT
43,43,61,104,113,63,115,67,66,63,72,43,14,114,73,109,78,112,123,57,129,176,139,121,FLAT
55,63,5,68,104,113,63,115,43,-1,35,55,109,62,107,98,57,113,108,164,121,111,158,112,FLAT
16,36,8,44,68,104,113,63,55,19,43,16,98,18,78,71,164,81,150,114,112,132,151,180,FLAT
11,45,12,57,44,68,104,113,16,15,2,11,71,34,45,27,114,33,80,82,180,96,152,125,FLAT
-55,16,55,71,57,44,68,104,11,-12,-26,-55,27,3,-24,-44,82,22,19,-28,125,21,54,27,FLAT
80,102,54,156,71,57,44,68,-55,79,-6,80,-44,67,-32,25,-28,82,-30,36,27,101,13,52,FLAT
-27,0,59,59,66,75,156,71,-20,-11,-4,-27,-29,-8,8,-47,51,-51,46,-56,-4,28,40,24,FLAT
-5,30,8,38,59,66,75,156,-27,-56,-35,-5,-47,-67,-39,-32,-56,-64,-27,-52,24,-107,11,-61,FLAT
1,16,25,41,38,59,66,75,-5,18,15,1,-32,-38,-20,-4,-52,-49,-24,-31,-61,-46,-12,-51,FLAT
-1,9,40,49,41,38,59,66,1,14,6,-1,-4,32,21,0,-31,-24,-14,-5,-51,-35,-18,-32,FLAT
19,33,21,54,49,41,38,59,-1,0,-5,19,0,14,1,18,-5,32,16,19,-32,-24,-19,14,FLAT
7,36,5,41,54,49,41,38,19,-9,4,7,18,-9,-1,26,19,5,5,25,14,23,20,26,FLAT
3,36,12,48,41,54,49,41,7,10,3,3,26,1,7,10,25,1,2,29,26,15,8,28,FLAT
-28,20,29,49,75,48,41,54,-63,-65,-39,-28,-60,-74,-75,-91,-53,-64,-72,-88,-34,-73,-68,-81,FLAT
-58,10,62,72,49,75,48,41,-28,-25,-48,-58,-91,-90,-87,-86,-88,-99,-123,-149,-81,-89,-120,-146,FLAT
-6,26,39,65,72,49,75,48,-58,-29,-22,-6,-86,-54,-70,-64,-149,-119,-109,-92,-146,-128,-145,-155,FLAT
43,168,53,221,65,72,49,75,-6,57,-99,43,-64,28,-121,37,-92,3,-169,-21,-155,-62,-208,-49,FLAT
-32,69,46,115,221,65,72,49,43,-39,67,-32,37,18,-32,11,-21,-11,-54,5,-49,-36,-102,-53,FLAT
32,40,44,84,115,221,65,72,-32,30,61,32,11,-9,128,0,5,48,29,43,-53,19,7,37,FLAT
-96,10,100,110,84,115,221,65,32,-40,-66,-96,0,-10,-5,-64,43,-49,62,-96,37,8,-37,-53,FLAT
120,136,3,139,110,84,115,221,-96,23,-6,120,-64,-17,-72,24,-96,13,-11,56,-53,-26,56,24,FLAT
-120,3,139,142,139,110,84,115,120,16,13,-120,24,39,7,0,56,-1,-59,-96,24,29,2,-64,FLAT
-146,2,155,157,142,139,110,84,-120,-130,-145,-146,0,-114,-132,-266,-96,-91,-138,-146,-64,-131,-204,-242,FLAT
108,117,3,120,157,142,139,110,-146,-44,-7,108,-266,-174,-152,-38,-146,-158,-139,-158,-242,-135,-145,-38,FLAT
-44,26,59,85,120,157,142,139,108,12,47,-44,-38,-32,40,64,-158,-162,-105,-82,-38,-146,-92,-202,FLAT
-6,40,60,100,85,120,157,142,-44,-5,-20,-6,64,7,27,-50,-82,-37,20,58,-202,-167,-125,-88,FLAT
-96,14,113,127,100,85,120,157,-6,-43,-70,-96,-50,-48,-90,-102,58,-36,-43,-146,-88,-80,-50,-38,FLAT
70,83,9,92,127,100,85,120,-96,-34,1,70,-102,-77,-69,-26,-146,-82,-89,-32,-38,-70,-42,-76,FLAT
-76,14,84,98,92,127,100,85,70,-1,-7,-76,-26,-35,-6,-6,-32,-78,-76,-102,-76,-83,-96,-108,FLAT
84,92,15,107,98,92,127,100,-76,15,6,84,-6,14,-1,8,-102,-20,0,78,-108,-63,-70,-18,FLAT
3,8,38,46,107,98,92,127,84,26,87,3,8,41,93,87,78,40,86,11,-18,6,87,81,FLAT
11,22,18,40,46,107,98,92,3,-9,-3,11,87,17,84,14,11,32,90,98,81,31,83,22,FLAT
24,44,0,44,40,46,107,98,11,6,2,24,14,-3,-1,35,98,23,86,38,22,38,92,122,FLAT
-17,2,54,56,44,40,46,107,24,37,25,-17,35,43,27,7,38,34,24,18,122,60,111,21,FLAT
-34,19,43,62,56,44,40,46,-17,-45,-51,-34,7,-8,-26,-51,18,-2,-24,-27,21,-11,-27,-16,FLAT
49,56,0,56,62,56,44,40,-34,6,12,49,-51,-39,-39,15,-27,-2,-14,-2,-16,4,-12,22,FLAT
-20,0,49,49,56,62,56,44,49,29,36,-20,15,35,48,29,-2,-10,-3,-5,22,27,22,-22,FLAT
7,8,34,42,49,56,62,56,-20,-8,-1,7,29,21,35,-13,-5,27,47,36,-22,-18,-4,2,FLAT
-15,11,21,32,15,31,31,48,-5,0,-17,-15,-28,-25,-26,-20,-25,-36,-37,-43,-40,-57,-41,-40,FLAT
-24,1,26,27,32,15,31,31,-15,-19,-14,-24,-20,-19,-31,-39,-43,-44,-40,-44,-40,-55,-51,-67,FLAT
28,28,7,35,27,32,15,31,-24,9,1,28,-39,-10,-13,4,-44,-10,-30,-11,-67,-35,-39,-16,FLAT
5,6,12,18,35,27,32,15,28,10,27,5,4,19,28,33,-11,0,14,9,-16,0,-3,-6,FLAT
0,18,6,24,26,18,35,27,-18,-12,-10,0,-13,-24,-30,-18,15,-14,-3,-13,-9,-5,-2,15,FLAT
0,11,24,35,51,24,26,18,-45,-22,-6,0,-45,-27,-38,-45,-63,-39,-48,-45,-58,-51,-68,-63,FLAT
-69,9,71,80,35,51,24,26,0,-22,-67,-69,-45,-44,-73,-69,-45,-49,-105,-114,-63,-61,-115,-114,FLAT
-1,31,20,51,80,35,51,24,-69,-52,-23,-1,-69,-74,-90,-70,-114,-96,-96,-70,-114,-101,-128,-115,FLAT
69,72,10,82,51,80,35,51,-1,59,28,69,-70,7,5,68,-70,-15,-62,-1,-115,-37,-68,-1,FLAT
-10,12,52,64,82,51,80,35,69,32,50,-10,68,91,78,59,-1,39,55,58,-1,17,-12,-11,FLAT
-53,22,69,91,64,82,51,80,-10,-36,-63,-53,59,-4,-13,-63,58,55,15,6,-11,3,-8,5,FLAT
63,71,37,108,91,64,82,51,-53,31,14,63,-63,-5,-49,10,6,27,1,0,5,86,29,69,FLAT
-160,53,174,227,108,91,64,82,63,-23,-142,-160,10,8,-128,-97,0,-28,-191,-150,69,4,-141,-160,FLAT
-24,31,45,76,227,108,91,64,-160,-153,-2,-24,-97,-176,-144,-184,-150,-145,-130,-121,-160,-181,-193,-174,FLAT
-100,5,107,112,76,227,108,91,-24,-38,-74,-100,-184,-191,-76,-124,-121,-214,-218,-284,-174,-183,-204,-221,FLAT
66,68,21,89,112,76,227,108,-100,-20,3,66,-124,-58,-71,-34,-284,-211,-73,-58,-221,-234,-215,-218,FLAT
50,81,6,87,89,112,76,227,66,35,37,50,-34,15,40,116,-58,-23,-34,16,-218,-176,-36,-8,FLAT
-19,16,67,83,87,89,112,76,50,42,46,-19,116,77,83,31,16,57,86,97,-8,19,12,-3,FLAT
-123,19,134,153,83,87,89,112,-19,-56,-126,-123,31,-14,-80,-142,97,21,-43,-92,-3,1,-40,-26,FLAT
-79,7,79,86,153,83,87,89,-123,-134,-67,-79,-142,-190,-193,-202,-92,-148,-147,-221,-26,-113,-110,-171,FLAT
60,61,7,68,86,153,83,87,-79,-12,6,60,-202,-146,-61,-19,-221,-202,-187,-142,-171,-160,-141,-161,FLAT
20,32,33,65,68,86,153,83,60,46,49,20,-19,34,55,80,-142,-100,-12,1,-161,-156,-138,-122,FLAT
15,48,17,65,65,68,86,153,20,-1,-1,15,80,45,48,35,1,33,54,95,-122,-101,-13,16,FLAT
-19,19,25,44,65,65,68,86,15,-11,10,-19,35,-12,9,-4,95,34,58,16,16,22,64,76,FLAT
18,27,21,48,44,65,65,68,-19,14,10,18,-4,3,20,-1,16,2,19,14,76,48,68,34,FLAT
-31,29,39,68,48,44,65,65,18,-13,-33,-31,-1,1,-23,-13,14,-10,-13,-32,34,-11,-14,-17,FLAT
27,35,15,50,68,48,44,65,-31,3,21,27,-13,-10,-12,-4,-32,4,-2,14,-17,-7,8,-5,FLAT
22,51,4,55,50,68,48,44,27,11,6,22,-4,14,27,49,14,1,-6,18,-5,15,4,36,FLAT
54,63,15,78,55,50,68,48,22,65,42,54,49,76,48,76,18,79,69,103,36,66,36,72,FLAT
29,39,6,45,78,55,50,68,54,20,53,29,76,85,95,83,103,96,101,105,72,99,122,132,FLAT
-157,3,166,169,45,78,55,50,29,3,-121,-157,83,23,-68,-128,105,88,-26,-74,132,99,-20,-52,FLAT
31,37,26,63,169,45,78,55,-157,-109,-3,31,-128,-106,-124,-126,-74,-86,-71,-97,-52,-21,-29,-43,FLAT
-16,1,52,53,63,169,45,78,31,10,20,-16,-126,-99,17,15,-97,-96,-104,-142,-43,-76,-51,-113,FLAT
-71,61,96,157,53,63,169,45,-16,-27,-131,-71,15,-17,-111,-87,-142,-126,-114,-56,-113,-123,-235,-213,FLAT
45,79,75,154,157,53,63,169,-71,24,27,45,-87,-3,-104,-26,-56,7,-84,-42,-213,-102,-87,-11,FLAT
102,102,49,151,154,157,53,63,45,76,79,102,-26,100,106,147,-42,73,-25,76,-11,83,-5,60,FLAT
-34,0,57,57,151,154,157,53,102,-26,68,-34,147,50,147,68,76,74,174,113,60,47,43,42,FLAT
-81,39,84,123,57,151,154,157,-34,-54,-120,-81,68,-80,-52,-115,113,-4,27,-13,42,20,54,32,FLAT
-71,6,77,83,123,57,151,154,-81,-78,-38,-71,-115,-132,-158,-152,-13,-158,-90,-186,32,-82,-11,-84,FLAT
33,86,5,91,83,123,57,151,-71,-39,-47,33,-152,-117,-85,-38,-186,-171,-205,-119,-84,-197,-137,-153,FLAT
108,118,6,124,91,83,123,57,33,109,76,108,-38,70,29,141,-119,-8,-9,70,-153,-62,-129,-11,FLAT
-3,73,36,109,124,91,83,123,108,27,42,-3,141,136,118,105,70,97,71,138,-11,19,33,67,FLAT
-86,13,87,100,109,124,91,83,-3,-35,-26,-86,105,-8,16,-89,138,101,92,19,67,62,45,52,FLAT
13,44,11,55,100,109,124,91,-86,-63,-18,13,-89,-98,-44,-73,19,-71,-2,-76,52,38,74,32,FLAT
54,58,25,83,55,100,109,124,13,68,40,54,-73,5,22,67,-76,-30,-4,-19,32,-3,38,-22,FLAT
59,73,1,74,83,55,100,109,54,35,44,59,67,103,84,113,-19,40,66,126,-22,5,40,40,FLAT
-40,21,69,90,74,83,55,100,59,28,12,-40,113,63,56,19,126,131,96,73,40,68,78,86,FLAT
49,52,5,57,90,74,83,55,-40,-15,18,49,19,13,30,9,73,48,74,68,86,116,114,122,FLAT
-5,36,6,42,57,90,74,83,49,-4,11,-5,9,-19,29,44,68,9,41,4,122,44,85,63,FLAT
66,69,0,69,42,57,90,74,-5,60,33,66,44,56,44,61,4,41,62,110,63,69,74,70,FLAT
15,22,36,58,69,42,57,90,66,51,62,15,61,111,95,81,110,107,106,76,70,92,124,125,FLAT
49,50,11,61,58,69,42,57,15,24,21,49,81,75,83,64,76,135,116,130,125,131,127,125,FLAT
-25,27,25,52,61,58,69,42,49,-11,-2,-25,64,13,19,24,130,64,81,39,125,124,114,105,FLAT
-12,6,61,67,52,61,58,69,-25,24,9,-12,24,13,7,-37,39,37,28,12,105,88,90,27,FLAT
9,21,3,24,67,52,61,58,-12,-49,-6,9,-37,-25,3,-3,12,-36,1,-28,27,-12,22,21,FLAT
6,21,8,29,37,38,29,23,-27,-17,-9,6,-56,-42,-33,-21,-73,-67,-67,-50,-65,-68,-74,-67,FLAT
-32,14,39,53,29,37,38,29,6,-1,-25,-32,-21,-18,-34,-26,-50,-43,-58,-53,-67,-68,-92,-82,FLAT
12,13,14,27,53,29,37,38,-32,-13,13,12,-26,-14,-12,-20,-53,-31,-21,-14,-82,-56,-45,-41,FLAT
-26,5,35,40,27,53,29,37,12,-5,-18,-26,-20,-18,-5,-14,-14,-19,-30,-46,-41,-36,-39,-40,FLAT
-23,3,25,28,40,27,53,29,-26,-33,-21,-23,-14,-38,-39,-49,-46,-51,-26,-37,-40,-52,-51,-69,FLAT
-12,18,23,41,28,40,27,53,-23,-14,-27,-12,-49,-47,-48,-35,-37,-52,-66,-61,-69,-65,-53,-49,FLAT
2,7,15,22,41,28,40,27,-12,-6,13,2,-35,-20,-14,-10,-61,-53,-35,-33,-49,-58,-53,-59,FLAT
-2,4,43,47,22,41,28,40,2,26,1,-2,-10,20,14,0,-33,6,-13,-12,-59,-27,-34,-35,FLAT
-13,33,24,57,47,22,41,28,-2,-32,-42,-13,0,-6,-41,-15,-12,-12,-28,-13,-35,-26,-55,-25,FLAT
-39,8,81,89,57,47,22,41,-13,18,-14,-39,-15,-14,-56,-52,-13,12,-55,-54,-25,6,-42,-52,FLAT
63,67,16,83,89,57,47,22,-39,-2,4,63,-52,16,-10,24,-54,-16,-52,11,-52,10,-51,9,FLAT
-20,26,36,62,83,89,57,47,63,0,21,-20,24,-2,25,43,11,16,11,4,9,-16,-31,-9,FLAT
-47,26,55,81,62,83,89,57,-20,-28,-47,-47,43,-28,-26,-67,4,-30,-22,-4,-9,-12,-36,-43,FLAT
21,30,29,59,81,62,83,89,-47,-5,17,21,-67,-33,-30,-26,-4,-33,-9,-46,-43,-35,-5,17,FLAT
-71,18,80,98,59,81,62,83,21,-20,-59,-71,-26,-25,-42,-50,-46,-53,-89,-97,17,-53,-68,-117,FLAT
27,41,28,69,98,59,81,62,-71,-25,4,27,-50,-45,-55,-44,-97,-50,-38,-23,-117,-78,-85,-70,FLAT
-75,72,102,174,69,98,59,81,27,-1,-106,-75,-44,-26,-102,-48,-23,-46,-161,-119,-70,-51,-144,-98,FLAT
5,40,54,94,174,69,98,59,-75,-43,37,5,-48,-44,-69,-70,-119,-69,-65,-43,-98,-89,-124,-114,FLAT
11,48,37,85,94,174,69,98,5,-6,3,11,-70,-49,40,16,-43,-50,-66,-59,-114,-75,-62,-32,FLAT
18,62,12,74,85,94,174,69,11,-7,4,18,16,-13,7,29,-59,-56,44,34,-32,-57,-62,-41,FLAT
-30,44,36,80,74,85,94,174,18,-6,-12,-30,29,-13,-8,-12,34,-19,-5,-1,-41,-62,32,4,FLAT
1,23,27,50,80,74,85,94,-30,-8,22,1,-12,-14,10,-29,-1,-21,14,-11,4,-27,17,0,FLAT
-88,7,88,95,50,80,74,85,1,-27,-72,-88,-29,-35,-50,-87,-11,-41,-62,-117,0,-48,-58,-99,FLAT
94,94,4,98,95,50,80,74,-88,10,7,94,-87,-17,-65,6,-117,-25,-43,7,-99,-31,-55,-23,FLAT
9,22,19,41,98,95,50,80,94,24,81,9,6,34,88,103,7,7,16,15,-23,-1,38,16,FLAT
-51,2,64,66,41,98,95,50,9,-6,-31,-51,103,18,50,-42,15,28,57,52,16,1,-15,-36,FLAT
-43,6,44,50,66,41,98,95,-51,-63,-47,-43,-42,-69,-78,-94,52,-45,3,-85,-36,-35,10,9,FLAT
-5,30,21,51,50,66,41,98,-43,-28,-29,-5,-94,-91,-76,-48,-85,-97,-107,-99,9,-73,-26,-90,FLAT
68,69,13,82,51,50,66,41,-5,60,29,68,-48,32,0,63,-99,-31,-47,20,-90,-37,-78,-31,FLAT
-12,27,17,44,82,51,50,66,68,-8,30,-12,63,52,59,56,20,24,30,51,-31,-39,-17,8,FLAT
-31,27,41,68,44,82,51,50,-12,-7,-31,-31,56,-15,-1,-43,51,45,28,25,8,17,-1,20,FLAT
59,71,14,85,68,44,82,51,-31,32,15,59,-43,25,-16,28,25,17,14,16,20,77,43,84,FLAT
-18,20,18,38,85,68,44,82,59,-14,33,-18,28,18,48,41,16,11,17,10,84,3,47,-2,FLAT
25,48,0,48,38,85,68,44,-18,7,-3,25,41,-7,30,7,10,25,45,66,-2,18,14,35,FLAT
-54,26,57,83,48,38,85,68,25,3,-32,-54,7,10,-35,-29,66,-4,-2,-47,35,28,13,12,FLAT
-155,72,160,232,83,48,38,85,-54,-52,-201,-155,-29,-49,-233,-209,-47,-42,-236,-184,12,-56,-203,-202,FLAT
-64,50,90,140,232,83,48,38,-155,-134,-42,-64,-209,-186,-243,-219,-184,-183,-275,-273,-202,-176,-278,-248,FLAT
-25,2,74,76,140,232,83,48,-64,-41,23,-25,-219,-175,-19,-89,-273,-227,-220,-244,-248,-224,-252,-298,FLAT
-1,15,65,80,76,140,232,83,-25,-10,-14,-1,-89,-51,9,-26,-244,-185,-33,-90,-298,-237,-234,-245,FLAT
-40,6,51,57,80,76,140,232,-1,-54,-31,-40,-26,-64,-45,-41,-90,-105,-22,-66,-245,-239,-64,-130,FLAT
-57,28,61,89,57,80,76,140,-40,-47,-79,-57,-41,-101,-110,-97,-66,-111,-124,-98,-130,-152,-101,-123,FLAT
35,50,20,70,89,57,80,76,-57,-6,13,35,-97,-53,-66,-22,-98,-107,-97,-62,-123,-117,-111,-63,FLAT
30,34,23,57,70,89,57,80,35,33,46,30,-22,27,59,65,-62,-20,-20,8,-63,-74,-51,-32,FLAT
-123,16,139,155,57,70,89,57,30,-7,-105,-123,65,26,-59,-93,8,20,-46,-58,-32,-27,-125,-115,FLAT
-28,23,51,74,155,57,70,89,-123,-116,-35,-28,-93,-123,-140,-151,-58,-90,-94,-121,-115,-96,-81,-86,FLAT
-22,39,53,92,74,155,57,70,-28,-20,-38,-22,-151,-136,-73,-50,-121,-143,-178,-173,-86,-110,-132,-143,FLAT
59,69,3,72,92,74,155,57,-22,9,29,59,-50,-11,-9,37,-173,-127,-44,9,-143,-134,-149,-114,FLAT
6,37,8,45,72,92,74,155,59,11,38,6,37,20,67,65,9,0,29,43,-114,-116,-6,15,FLAT
19,26,32,58,45,72,92,74,6,43,30,19,65,54,68,25,43,63,97,84,15,43,59,62,FLAT
-40,7,98,105,58,45,72,92,19,26,-21,-40,25,69,9,-21,84,80,47,-15,62,89,76,44,FLAT
-47,6,71,77,105,58,45,72,-40,-74,-46,-47,-21,-48,-67,-87,-15,-5,-37,-68,44,6,1,-62,FLAT
-10,10,18,28,77,105,58,45,-47,-63,-14,-10,-87,-137,-60,-57,-68,-111,-81,-97,-62,-68,-51,-78,FLAT
-26,7,38,45,28,77,105,58,-10,-6,-23,-26,-57,-69,-37,-36,-97,-143,-83,-83,-78,-117,-104,-123,FLAT
-5,2,20,22,45,28,77,105,-26,-23,0,-5,-36,-29,-23,-31,-83,-92,-37,-41,-123,-166,-83,-88,FLAT
35,36,4,40,22,45,28,77,-5,19,1,35,-31,-4,1,30,-41,-10,-22,4,-88,-73,-36,-6,FLAT
-15,14,26,40,40,22,45,28,35,7,7,-15,30,26,8,20,4,3,8,15,-6,-3,-15,-11,FLAT
20,25,1,26,40,40,22,45,-15,-5,9,20,20,2,16,5,15,21,17,40,-11,-2,17,35,FLAT
-9,16,12,28,33,28,49,86,0,-20,-15,-9,0,-2,-2,-9,-28,-28,-7,-9,25,-44,14,-37,FLAT
-11,11,20,31,28,33,28,49,-9,-3,-6,-11,-9,-23,-21,-20,-9,-5,-8,-20,-37,-31,-13,-20,FLAT
-38,3,43,46,31,28,33,28,-11,-15,-30,-38,-20,-18,-36,-49,-20,-38,-51,-58,-20,-20,-38,-58,FLAT
-22,8,24,32,46,31,28,33,-38,-41,-27,-22,-49,-56,-57,-60,-58,-59,-63,-71,-58,-79,-78,-80,FLAT
21,23,2,25,32,46,31,28,-22,-1,6,21,-60,-42,-21,-1,-71,-57,-51,-39,-80,-60,-57,-50,FLAT
-9,11,10,21,20,25,32,46,9,-8,-9,-9,30,8,12,0,8,7,18,21,-30,-34,-9,-1,FLAT
15,35,0,35,21,20,25,32,-9,5,-9,15,0,-3,-18,6,21,13,3,15,-1,12,9,36,FLAT
38,38,24,62,35,21,20,25,15,62,35,38,6,67,26,53,15,59,17,44,36,75,38,53,FLAT
123,141,20,161,62,35,21,20,38,119,20,123,53,181,55,161,44,186,46,176,53,178,37,167,FLAT
93,97,18,115,161,62,35,21,123,91,137,93,161,210,157,216,176,272,192,254,167,277,183,269,FLAT
-75,16,87,103,115,161,62,35,93,-6,6,-75,216,85,143,18,254,204,163,141,269,266,198,179,FLAT
-13,15,31,46,103,115,161,62,-75,-69,-12,-13,18,-75,-6,-88,141,16,131,5,179,135,151,128,FLAT
0,8,87,95,46,103,115,161,-13,56,7,0,-88,-13,-5,-13,5,-19,1,-88,128,72,138,5,FLAT
-30,11,61,72,95,46,103,115,0,-56,-33,-30,-13,0,-26,-30,-88,-69,-38,-43,5,-75,-32,-118,FLAT
-22,26,62,88,72,95,46,103,-30,-21,-37,-22,-30,-77,-70,-52,-43,-21,-63,-52,-118,-90,-75,-65,FLAT
11,15,59,74,88,72,95,46,-22,8,22,11,-52,-13,-15,-11,-52,-69,-48,-41,-65,-13,-41,-41,FLAT
-2,64,5,69,74,88,72,95,11,-56,-51,-2,-11,-48,-29,9,-41,-69,-66,-13,-41,-125,-99,-43,FLAT
94,99,39,138,71,69,74,88,40,123,56,94,38,168,99,134,49,112,48,132,27,120,70,143,FLAT
-25,15,46,61,138,71,69,74,94,-18,59,-25,134,105,115,69,132,150,158,109,143,94,107,107,FLAT
25,30,47,77,61,138,71,69,-25,26,10,25,69,8,69,0,109,131,125,94,107,176,168,134,FLAT
-19,5,60,65,77,61,138,71,25,-6,6,-19,0,20,16,6,94,2,75,-19,134,125,131,75,FLAT
82,84,73,157,65,77,61,138,-19,95,3,82,6,89,9,63,-19,115,19,88,75,97,78,63,FLAT
57,63,11,74,157,65,77,61,82,-5,78,57,63,90,81,139,88,84,87,120,63,110,97,145,FLAT
-62,25,63,88,74,157,65,77,57,-10,-24,-62,139,-15,54,-5,120,80,57,77,145,74,63,58,FLAT
14,75,7,82,88,74,157,65,-62,-42,-36,14,-5,-52,-60,-48,77,-57,18,9,58,38,21,91,FLAT
-34,38,39,77,82,88,74,157,14,-2,3,-34,-48,-44,-33,-20,9,-54,-57,-82,91,-59,21,-25,FLAT
0,23,12,35,77,82,88,74,-34,-27,15,0,-20,-29,18,-34,-82,-71,-18,-20,-25,-81,-42,-82,FLAT
4,21,35,56,35,77,82,88,0,27,6,4,-34,0,21,4,-20,-2,24,-30,-82,-44,-12,-16,FLAT
12,37,31,68,56,35,77,82,4,8,-4,12,4,35,2,16,-30,8,17,16,-16,6,20,-18,FLAT
67,98,5,103,85,68,56,35,60,48,30,67,72,101,66,127,76,109,62,139,76,136,68,143,FLAT
-8,17,36,53,103,85,68,56,67,23,73,-8,127,71,103,59,139,124,139,119,143,132,135,131,FLAT
54,74,23,97,53,103,85,68,-8,41,-3,54,59,64,70,46,119,112,100,113,131,165,136,173,FLAT
-26,12,130,142,97,53,103,85,54,81,36,-26,46,122,33,28,113,145,106,20,173,193,136,87,FLAT
-87,6,108,114,80,142,97,53,-49,-54,-88,-87,-75,-158,-130,-136,-21,-77,-94,-162,-29,-36,-97,-108,FLAT
-25,16,47,63,114,80,142,97,-87,-86,-35,-25,-136,-140,-123,-112,-162,-244,-165,-161,-108,-163,-129,-187,FLAT
-7,18,35,53,63,114,80,142,-25,-19,-9,-7,-112,-105,-44,-32,-161,-159,-132,-119,-187,-263,-174,-168,FLAT
12,60,14,74,53,63,114,80,-7,-9,-30,12,-32,-28,-39,5,-119,-114,-74,-20,-168,-168,-162,-107,FLAT
-59,30,61,91,74,53,63,114,12,-12,-29,-59,5,-21,-59,-47,-20,-40,-68,-54,-107,-126,-103,-79,FLAT
42,46,28,74,91,74,53,63,-59,9,26,42,-47,-3,-3,-17,-54,-12,-33,-5,-79,-31,-42,-12,FLAT
-43,2,63,65,74,91,74,53,42,-8,1,-43,-17,1,27,-1,-5,-11,-2,-60,-12,-20,-32,-48,FLAT
-33,15,36,51,65,74,91,74,-43,-60,-46,-33,-1,-68,-45,-76,-60,-59,-19,-34,-48,-71,-48,-93,FLAT
110,146,15,161,51,65,74,91,-33,89,-21,110,-76,29,-67,77,-34,21,-66,34,-93,30,-40,76,FLAT
34,77,62,139,301,161,51,65,162,-41,121,34,272,243,265,196,239,332,244,306,196,272,198,273,FLAT
26,102,9,111,139,301,161,51,34,-27,1,26,196,-68,122,60,306,216,266,222,273,305,245,332,FLAT
-10,15,49,64,111,139,301,161,26,30,77,-10,60,3,78,16,222,-38,199,50,332,246,343,212,FLAT
-42,24,45,69,64,111,139,301,-10,-46,-51,-42,16,-16,26,-52,50,-43,27,-26,212,-84,148,8,FLAT
35,59,4,63,69,64,111,139,-42,-6,0,35,-52,-52,-51,-7,-26,-22,26,-17,8,-49,27,9,FLAT
35,35,43,78,63,69,64,111,35,74,59,35,-7,68,59,70,-17,22,8,28,9,52,85,18,FLAT
-24,2,36,38,78,63,69,64,35,-31,9,-24,70,43,68,11,28,37,68,46,18,-9,17,4,FLAT
29,34,2,36,38,78,63,69,-24,-5,-3,29,11,-36,6,5,46,38,65,40,4,32,65,75,FLAT
71,74,4,78,36,38,78,63,29,73,31,71,5,68,28,100,40,37,37,76,75,111,96,111,FLAT
9,25,17,42,47,45,26,39,-34,-9,-4,9,-16,-18,-15,-25,-1,-1,-17,-7,-18,-2,-5,8,FLAT
10,24,8,32,42,47,45,26,9,1,11,10,-25,-8,7,19,-7,-17,-4,-15,8,0,-6,3,FLAT
-10,8,15,23,32,42,47,45,10,-3,6,-10,19,-2,17,0,-15,-11,13,9,3,-20,2,-25,FLAT
-35,7,38,45,23,32,42,47,-10,-12,-34,-35,0,-15,-28,-45,9,-14,-17,-35,-25,-23,-21,-26,FLAT
-5,5,11,16,45,23,32,42,-35,-32,-3,-5,-45,-44,-37,-40,-35,-47,-31,-50,-26,-46,-20,-40,FLAT
-35,1,52,53,16,45,23,32,-5,6,-31,-35,-40,-26,-34,-40,-50,-38,-68,-75,-40,-41,-62,-85,FLAT
2,32,10,42,53,16,45,23,-35,-40,-29,2,-40,-34,-60,-33,-75,-66,-63,-38,-85,-78,-97,-73,FLAT
-43,4,47,51,42,53,16,45,2,-6,-15,-43,-33,-46,-44,-41,-38,-40,-75,-76,-73,-72,-78,-81,FLAT
15,47,58,105,51,42,53,16,-43,26,-28,15,-41,20,-43,-28,-76,-20,-72,-26,-81,-14,-103,-61,FLAT
93,111,12,123,105,51,42,53,15,47,29,93,-28,73,1,108,-26,67,-14,65,-61,27,-43,67,FLAT
-21,17,53,70,123,105,51,42,93,20,73,-21,108,67,102,72,65,93,74,87,67,87,59,44,FLAT
-84,6,94,100,70,123,105,51,-21,-43,-73,-84,72,-23,0,-105,87,24,29,-12,44,50,1,3,FLAT
-79,0,102,102,100,70,123,105,-84,-71,-73,-79,-105,-114,-146,-163,-12,-94,-73,-184,3,-47,-44,-91,FLAT
29,102,12,114,102,100,70,123,-79,-61,-73,29,-163,-132,-146,-50,-184,-175,-219,-134,-91,-155,-146,-155,FLAT
11,94,4,98,114,102,100,70,29,3,19,11,-50,-58,-54,40,-134,-129,-127,-39,-155,-172,-200,-123,FLAT
3,41,47,88,98,114,102,100,11,46,56,3,40,49,75,14,-39,-12,2,43,-123,-83,-71,-36,FLAT
-39,20,50,70,88,98,114,102,3,-36,-18,-39,14,10,38,-36,43,13,57,-25,-36,-48,-16,4,FLAT
4,17,30,47,70,88,98,114,-39,-16,7,4,-36,-52,-11,-35,-25,-6,45,-32,4,-3,64,-21,FLAT
88,132,4,136,47,70,88,98,4,62,-27,88,-35,46,-20,92,-32,10,-38,53,-21,56,18,56,FLAT
-18,35,24,59,136,47,70,88,88,2,79,-18,92,64,52,70,53,48,59,74,56,12,41,35,FLAT
49,74,15,89,59,136,47,70,-18,40,10,49,70,42,89,31,74,104,62,119,35,88,69,123,FLAT
27,46,4,50,89,59,136,47,49,16,55,27,31,56,65,76,119,58,144,58,123,120,117,146,FLAT
24,29,31,60,50,89,59,136,27,51,41,24,76,67,96,51,58,107,106,100,146,109,185,82,FLAT
-14,19,20,39,60,50,89,59,24,-25,-4,-14,51,26,37,10,100,42,92,37,82,82,102,86,FLAT
11,29,26,55,39,60,50,89,-14,17,1,11,10,-8,-3,-3,37,43,38,21,86,59,93,48,FLAT
81,87,2,89,55,39,60,50,11,57,23,81,-3,74,24,92,21,49,20,78,48,100,61,102,FLAT
-51,3,63,66,89,55,39,60,81,10,33,-51,92,67,56,30,78,84,57,41,102,59,53,27,FLAT
-13,18,34,52,66,89,55,39,-51,-42,-28,-13,30,-32,5,-64,41,25,28,17,27,42,29,28,FLAT
-57,7,70,77,52,66,89,55,-13,-21,-46,-57,-64,-63,-74,-70,17,-53,-41,-121,28,4,-18,-40,FLAT
27,31,15,46,77,52,66,89,-57,-28,3,27,-70,-49,-43,-30,-121,-91,-71,-43,-40,-81,-38,-94,FLAT
-36,28,41,69,46,77,52,66,27,-10,-33,-36,-30,-38,-30,-9,-43,-59,-76,-66,-94,-101,-104,-79,FLAT
64,79,3,82,69,46,77,52,-36,26,13,64,-9,16,-20,28,-66,-12,-17,55,-79,-33,-63,-2,FLAT
9,25,10,35,82,69,46,77,64,16,63,9,28,42,76,73,55,32,43,37,-2,4,46,64,FLAT
49,57,1,58,35,82,69,46,9,40,17,49,73,56,80,58,37,82,93,122,64,72,60,86,FLAT
-64,24,102,126,58,35,82,69,49,37,-31,-64,58,77,-14,-15,122,93,49,-6,86,119,62,58,FLAT
-18,37,67,104,126,58,35,82,-64,-53,-31,-18,-15,-16,-62,-82,-6,24,-45,-33,58,40,18,-24,FLAT
-64,8,86,94,104,126,58,35,-18,-45,-35,-64,-82,-98,-66,-82,-33,-61,-97,-146,-24,-21,-80,-97,FLAT
-40,4,61,65,94,104,126,58,-64,-65,-36,-40,-82,-110,-71,-104,-146,-163,-102,-122,-97,-126,-133,-186,FLAT
69,69,29,98,65,94,104,126,-40,37,4,69,-104,-28,-32,29,-122,-73,-67,-35,-186,-126,-98,-53,FLAT
-35,32,53,85,98,65,94,104,69,-11,2,-35,29,26,6,34,-35,-39,-30,-6,-53,-84,-65,-70,FLAT
-12,60,133,193,85,98,65,94,-35,68,-40,-12,34,57,-38,-47,-6,94,-34,22,-70,29,-70,-18,FLAT
-49,62,78,140,193,85,98,65,-12,-104,-51,-49,-47,-36,-91,-61,22,-47,-89,-96,-18,-10,-85,-27,FLAT
63,64,27,91,140,193,85,98,-49,12,61,63,-61,-92,10,14,-96,-24,-30,2,-27,-35,-28,-33,FLAT
-140,11,140,151,91,140,193,85,63,-27,-87,-140,14,-15,-26,-77,2,-119,-77,-126,-33,-51,-117,-138,FLAT
-3,3,63,66,151,91,140,193,-140,-80,5,-3,-77,-107,-82,-143,-126,-95,-21,-80,-138,-199,-72,-129,FLAT
38,60,6,66,66,151,91,140,-3,-19,-19,38,-143,-99,-14,35,-80,-126,-101,-105,-129,-114,-40,-42,FLAT
-29,0,50,50,66,66,151,91,38,15,31,-29,35,-4,12,9,-105,-84,17,6,-42,-111,-70,-134,FLAT
61,78,28,106,50,66,66,151,-29,39,-17,61,9,54,14,32,6,35,-5,70,-134,-45,0,67,FLAT
26,50,24,74,106,50,66,66,61,22,54,26,32,61,37,87,70,76,68,58,67,57,49,96,FLAT
76,94,15,109,74,106,50,66,26,67,32,76,87,89,86,102,58,128,69,163,96,143,100,134,FLAT
-13,42,24,66,109,74,106,50,76,-4,39,-13,102,63,71,63,163,85,125,89,134,124,108,150,FLAT
-44,1,50,51,66,109,74,106,-13,-18,-3,-44,63,-22,36,-57,89,45,68,19,150,67,122,45,FLAT
69,86,4,90,51,66,109,74,-44,23,-16,69,-57,5,-19,25,19,1,20,12,45,68,52,88,FLAT
-51,22,61,83,90,51,66,109,69,6,13,-51,25,29,-3,18,12,11,-6,-26,88,7,33,-39,FLAT
24,28,7,35,83,90,51,66,-51,-30,18,24,18,-24,31,-27,-26,-1,15,42,-39,-19,12,-2,FLAT
43,58,23,81,35,83,90,51,24,59,13,43,-27,29,31,67,42,35,44,16,-2,58,28,85,FLAT
-10,18,14,32,50,22,56,43,37,-2,16,-10,37,20,10,27,-13,-12,12,27,20,-13,-2,-23,FLAT
-3,19,6,25,32,50,22,56,-10,-11,-4,-3,27,-13,12,-13,27,9,6,24,-23,-23,8,24,FLAT
-5,10,14,24,25,32,50,22,-3,3,4,-5,-13,-8,0,-8,24,-10,16,-18,24,12,10,19,FLAT
25,29,9,38,24,25,32,50,-5,20,6,25,-8,23,10,20,-18,12,6,17,19,10,22,7,FLAT
6,14,2,16,38,24,25,32,25,-1,21,6,20,19,27,31,17,22,31,26,7,11,27,23,FLAT
-25,7,29,36,16,38,24,25,6,2,-18,-25,31,1,3,-19,26,21,9,6,23,24,13,1,FLAT
-40,5,44,49,36,16,38,24,-25,-25,-38,-40,-19,-23,-56,-65,6,-24,-35,-59,1,-4,-29,-34,FLAT
-29,8,29,37,49,36,16,38,-40,-44,-32,-29,-65,-69,-70,-69,-59,-67,-88,-94,-34,-68,-67,-88,FLAT
64,65,1,66,37,49,36,16,-29,36,7,64,-69,-8,-25,35,-94,-33,-63,-5,-88,-31,-81,-30,FLAT
9,51,25,76,66,37,49,36,64,33,23,9,35,69,30,73,-5,25,-2,44,-30,0,-40,4,FLAT
-14,21,49,70,76,66,37,49,9,10,16,-14,73,43,39,-5,44,79,46,59,4,35,14,30,FLAT
46,53,3,56,70,76,66,37,-14,0,14,46,-5,10,30,32,59,43,53,41,30,79,60,105,FLAT
-21,9,37,46,56,70,76,66,46,13,23,-21,32,13,37,25,41,23,53,11,105,56,76,20,FLAT
-76,38,100,138,132,46,56,70,-119,-99,-105,-76,-140,-132,-224,-195,-94,-119,-201,-216,-108,-119,-187,-170,FLAT
60,107,69,176,138,132,46,56,-76,29,-9,60,-195,-70,-114,-16,-216,-103,-233,-135,-170,-90,-210,-156,FLAT
77,120,1,121,176,138,132,46,60,9,64,77,-16,38,55,137,-135,-61,-50,61,-156,-94,-169,-58,FLAT
-67,75,80,155,121,176,138,132,77,12,-22,-67,137,21,42,10,61,50,33,70,-58,-49,-72,-6,FLAT
44,58,15,73,155,121,176,138,-67,-21,61,44,10,-9,39,-23,70,0,103,54,-6,29,94,114,FLAT
26,58,42,100,73,155,121,176,44,53,26,26,-23,32,87,70,54,44,65,3,114,53,129,80,FLAT
-6,9,42,51,100,73,155,121,26,-6,43,-6,70,47,69,20,3,26,130,64,80,38,108,-3,FLAT
-79,7,85,92,55,51,100,73,-50,-48,-85,-79,-56,-86,-127,-129,-30,-92,-84,-135,14,-39,-58,-109,FLAT
-93,5,117,122,92,55,51,100,-79,-61,-91,-93,-129,-109,-176,-172,-135,-147,-218,-222,-109,-153,-175,-228,FLAT
2,10,40,50,122,92,55,51,-93,-75,-3,2,-172,-136,-94,-91,-222,-184,-179,-170,-228,-222,-221,-220,FLAT
-74,8,77,85,50,122,92,55,2,-37,-72,-74,-91,-112,-75,-72,-170,-173,-166,-165,-220,-221,-251,-244,FLAT
-22,20,26,46,85,50,122,92,-74,-73,-34,-22,-72,-110,-106,-96,-165,-185,-109,-94,-244,-246,-200,-187,FLAT
41,46,29,75,46,85,50,122,-22,44,15,41,-96,-29,-19,19,-94,-66,-91,-55,-187,-141,-94,-53,FLAT
21,24,17,41,75,46,85,50,41,9,43,21,19,53,58,62,-55,-20,24,40,-53,-57,-48,-34,FLAT
22,47,6,53,41,75,46,85,21,11,-1,22,62,20,42,43,40,64,57,84,-34,-9,23,62,FLAT
13,31,33,64,53,41,75,46,22,40,29,13,43,51,28,35,84,60,71,56,62,104,86,97,FLAT
-21,10,48,58,64,53,41,75,13,-6,0,-21,35,34,29,-8,56,45,28,14,97,54,71,35,FLAT
-64,0,87,87,58,64,53,41,-21,-25,-54,-64,-8,-31,-54,-85,14,9,-25,-72,35,20,-26,-50,FLAT
70,70,9,79,87,58,64,53,-64,-8,0,70,-85,-33,-54,6,-72,-39,-54,-15,-50,1,-25,-2,FLAT
-23,14,52,66,79,87,58,64,70,20,33,-23,6,12,33,47,-15,-13,-21,-17,-2,-19,-21,-38,FLAT
-27,104,33,137,66,79,87,58,-23,-46,-117,-27,47,-26,-84,-50,-17,-34,-84,20,-38,-59,-138,-44,FLAT
-109,8,130,138,137,66,79,87,-27,-12,-13,-109,-50,-58,-130,-136,20,-38,-97,-159,-44,-46,-97,-89,FLAT
45,55,25,80,138,137,66,79,-109,-60,-2,45,-136,-72,-15,-64,-159,-118,-132,-91,-89,-98,-99,-114,FLAT
77,86,41,127,80,138,137,66,45,93,46,77,-64,33,44,122,-91,21,31,13,-114,-25,-86,-14,FLAT
15,39,42,81,127,80,138,137,77,16,62,15,122,109,108,92,13,49,106,137,-14,37,93,28,FLAT
46,153,29,182,81,127,80,138,15,33,-68,46,92,49,-6,61,137,142,40,138,28,82,38,183,FLAT
84,109,28,137,182,81,127,80,46,83,128,84,61,116,60,130,138,132,122,145,183,225,168,222,FLAT
-20,10,70,80,137,182,81,127,84,22,79,-20,130,105,207,64,145,138,139,110,222,154,201,125,FLAT
-22,16,43,59,103,80,137,182,-76,-78,-34,-22,-96,-125,-104,-98,-12,-103,-25,-118,34,-20,103,-34,FLAT
-23,4,42,46,59,103,80,137,-22,-24,-11,-23,-98,-102,-45,-45,-118,-149,-115,-121,-34,-127,-36,-141,FLAT
-28,11,31,42,46,59,103,80,-23,-39,-35,-28,-45,-63,-46,-51,-121,-141,-80,-73,-141,-188,-150,-149,FLAT
32,53,0,53,42,46,59,103,-28,1,-10,32,-51,-38,-45,4,-73,-62,-56,-19,-149,-140,-90,-41,FLAT
-61,1,83,84,53,42,46,59,32,22,-9,-61,4,23,-19,-29,-19,-16,-54,-57,-41,-40,-65,-80,FLAT
-93,13,107,120,84,53,42,46,-61,-69,-105,-93,-29,-47,-114,-154,-57,-46,-124,-122,-80,-85,-159,-150,FLAT
10,22,12,34,120,84,53,42,-93,-85,1,10,-154,-154,-104,-83,-122,-132,-113,-144,-150,-131,-123,-112,FLAT
-7,10,20,30,55,34,120,84,49,10,35,-7,59,50,54,42,-34,-35,55,52,-95,-104,-50,-41,FLAT
55,79,6,85,30,55,34,120,-7,41,-14,55,42,51,21,48,52,91,40,97,-41,6,41,107,FLAT
4,18,22,40,85,30,55,34,55,20,65,4,48,61,51,59,97,71,86,52,107,111,105,101,FLAT
42,57,13,70,40,85,30,55,4,33,3,42,59,53,68,46,52,94,54,101,101,104,89,94,FLAT
10,14,12,26,70,40,85,30,42,9,53,10,46,42,56,52,101,62,121,56,94,103,107,111,FLAT
14,16,1,17,26,26,71,25,-6,-8,1,14,-20,-8,1,8,30,-6,48,-6,13,24,32,44,FLAT
-26,8,26,34,17,26,26,71,14,-1,-18,-26,8,-9,-17,-12,-6,-9,-17,-18,44,-7,30,-32,FLAT
37,37,4,41,34,17,26,26,-26,15,8,37,-12,14,-10,11,-18,6,-9,25,-32,6,-9,19,FLAT
10,23,0,23,41,34,17,26,37,6,24,10,11,21,32,47,25,20,14,21,19,12,15,35,FLAT
-11,1,25,26,23,41,34,17,10,14,11,-11,47,20,35,-1,21,35,43,36,35,34,25,10,FLAT
26,30,0,30,26,23,41,34,-11,1,-3,26,-1,15,8,15,36,21,32,25,10,36,40,62,FLAT
-27,8,32,40,30,26,23,41,26,5,-5,-27,15,6,-8,-1,25,20,3,-12,62,26,27,-2,FLAT
17,27,4,31,40,30,26,23,-27,-11,-2,17,-1,-6,-7,-10,-12,-5,-10,16,-2,9,1,5,FLAT
21,28,27,55,31,40,30,26,17,44,20,21,-10,33,18,38,16,38,13,11,5,39,10,37,FLAT
13,33,43,76,55,31,40,30,21,29,8,13,38,73,28,34,11,62,26,51,37,67,21,24,FLAT
20,43,24,67,76,55,31,40,13,1,10,20,34,30,18,33,51,74,38,54,24,63,36,71,FLAT
-37,51,55,106,67,76,55,31,20,-6,-45,-37,33,-5,-35,-17,54,24,-27,-4,71,68,-7,17,FLAT
-55,15,70,85,106,67,76,55,-37,-40,-19,-55,-17,-46,-64,-92,-4,-45,-54,-72,17,-16,-46,-59,FLAT
-50,35,69,104,68,85,106,67,26,8,-28,-50,-29,-25,-44,-24,-66,-65,-63,-79,-46,-71,-108,-116,FLAT
89,140,15,155,104,68,85,106,-50,35,-16,89,-24,43,-44,39,-79,10,-60,65,-116,-30,-79,10,FLAT
-5,49,21,70,155,104,68,85,89,1,86,-5,39,36,70,84,65,44,42,34,10,11,26,60,FLAT
46,98,66,164,70,155,104,68,-5,91,-3,46,84,92,83,41,34,127,67,130,60,135,39,80,FLAT
-50,15,50,65,164,70,155,104,46,-66,33,-50,41,25,30,-4,130,26,116,-9,80,61,100,80,FLAT
3,20,45,65,103,65,164,70,-61,-31,7,3,-111,-63,-63,-58,-65,-129,-30,-108,-70,-38,-33,-62,FLAT
2,26,33,59,65,103,65,164,3,-10,-4,2,-58,-41,3,5,-108,-73,-67,-56,-62,-139,-34,-106,FLAT
25,54,7,61,59,65,103,65,2,-1,-3,25,5,-11,-7,27,-56,-42,0,30,-106,-74,-70,-31,FLAT
-36,12,52,64,61,59,65,103,25,9,6,-36,27,8,3,-11,30,-2,-1,-9,-31,-33,6,-6,FLAT
-31,5,56,61,64,61,59,65,-36,-27,-24,-31,-11,-18,-18,-67,-9,-19,-21,-42,-6,-29,-25,-40,FLAT
-167,4,169,173,61,64,61,59,-31,-54,-166,-167,-67,-81,-190,-198,-42,-72,-184,-234,-40,-73,-187,-209,FLAT
-45,41,48,89,173,61,64,61,-167,-166,-82,-45,-198,-220,-248,-212,-234,-247,-272,-243,-209,-238,-266,-279,FLAT
10,42,9,51,89,173,61,64,-45,-29,9,10,-212,-195,-73,-35,-243,-249,-239,-202,-279,-276,-263,-233,FLAT
-20,20,45,65,51,89,173,61,10,16,2,-20,-35,-13,11,-10,-202,-179,-71,-55,-233,-233,-237,-222,FLAT
56,76,13,89,150,65,51,89,118,42,103,56,98,142,118,174,108,158,120,154,63,129,129,164,FLAT
71,85,10,95,89,150,65,51,56,68,62,71,174,110,165,127,154,210,180,245,164,226,182,225,FLAT
49,124,0,124,95,89,150,65,71,39,10,49,127,107,72,120,245,149,175,176,225,249,190,294,FLAT
53,75,38,113,124,95,89,150,49,91,102,53,120,130,112,102,176,198,174,173,294,240,277,229,FLAT
52,79,100,179,113,124,95,89,53,114,48,52,102,205,150,105,173,244,160,154,229,312,222,225,FLAT
-23,31,24,55,179,113,124,95,52,-99,25,-23,105,15,73,29,154,106,175,82,225,145,185,131,FLAT
6,36,53,89,55,179,113,124,-23,35,1,6,29,-64,26,-17,82,50,74,35,131,141,176,88,FLAT
11,41,34,75,89,55,179,113,6,-8,6,11,-17,27,7,17,35,-72,32,-6,88,42,80,46,FLAT
-91,22,107,129,61,75,89,55,-47,-37,-105,-91,-36,-65,-119,-138,-30,-73,-113,-127,-53,-38,-112,-121,FLAT
-75,1,117,118,129,61,75,89,-91,-65,-54,-75,-138,-102,-159,-166,-127,-130,-173,-213,-121,-138,-167,-202,FLAT
-5,13,84,97,118,129,61,75,-75,-38,-17,-5,-166,-103,-71,-80,-213,-140,-176,-171,-202,-168,-190,-218,FLAT
-46,15,76,91,97,118,129,61,-5,-54,-48,-46,-80,-92,-65,-51,-171,-157,-119,-126,-218,-194,-224,-217,FLAT
-22,1,99,100,91,97,118,129,-46,1,-8,-22,-51,-53,-56,-68,-126,-91,-73,-73,-217,-156,-127,-148,FLAT
6,44,13,57,100,91,97,118,-22,-80,-37,6,-68,-79,-45,-16,-73,-133,-93,-62,-148,-171,-110,-67,FLAT
-50,6,65,71,57,100,91,97,6,2,-12,-50,-16,-78,-49,-44,-62,-77,-57,-66,-67,-131,-105,-112,FLAT
34,54,38,92,71,57,100,91,-50,7,-14,34,-44,9,-26,-16,-66,-71,-63,-10,-112,-70,-71,-32,FLAT
-38,20,39,59,92,71,57,100,34,-37,-4,-38,-16,-30,-18,-4,-10,-28,-30,-54,-32,-108,-67,-48,FLAT
11,35,13,48,59,92,71,57,-38,-15,-4,11,-4,-52,-8,-27,-54,-45,-22,7,-48,-43,-34,-43,FLAT
-66,23,96,119,48,59,92,71,11,17,-54,-66,-27,2,-58,-55,7,-35,-62,-93,-43,-28,-76,-59,FLAT
3,23,31,54,119,48,59,92,-66,-62,3,3,-55,-45,-51,-63,-93,-60,-55,-52,-59,-97,-59,-90,FLAT
82,85,8,93,54,119,48,59,3,59,20,82,-63,-3,23,85,-52,14,-31,19,-90,-1,-35,30,FLAT
-41,9,45,54,93,54,119,48,82,-4,35,-41,85,55,55,41,19,-7,58,44,30,10,4,-22,FLAT
-7,17,25,42,54,93,54,119,-41,-27,-15,-7,41,-31,20,-48,44,28,40,34,-22,-34,43,37,FLAT
75,75,12,87,42,54,93,54,-7,62,17,75,-48,35,2,68,34,31,37,27,37,90,57,109,FLAT
-27,20,56,76,87,42,54,93,75,17,28,-27,68,79,45,48,27,52,30,41,109,48,65,0,FLAT
-38,11,47,58,76,87,42,54,-27,-47,-29,-38,48,-30,-1,-65,41,32,16,10,0,5,1,3,FLAT
-9,0,28,28,24,65,19,25,13,18,14,-9,-20,-21,16,4,-32,-18,-27,-29,-49,-36,-39,-41,FLAT
5,12,10,22,28,24,65,19,-9,-13,-7,5,4,5,7,-4,-29,-34,9,9,-41,-31,-34,-24,FLAT
5,7,12,19,22,28,24,65,5,7,10,5,-4,-6,3,10,9,12,17,1,-24,-27,19,14,FLAT
-25,0,26,26,19,22,28,24,5,-11,-18,-25,10,-4,-8,-20,1,-17,-15,-15,14,1,-1,-24,FLAT
-18,15,21,36,26,19,22,28,-25,-23,-33,-18,-20,-34,-51,-43,-15,-27,-41,-38,-24,-40,-48,-33,FLAT
14,20,21,41,36,26,19,22,-18,14,9,14,-43,-9,-24,-4,-38,-20,-42,-29,-33,-13,-32,-24,FLAT
-3,17,17,34,41,36,26,19,14,-7,0,-3,-4,7,9,11,-29,-16,-24,-7,-24,-27,-42,-32,FLAT
17,20,7,27,34,41,36,26,-3,7,14,17,11,0,14,14,-7,14,23,28,-32,-9,-10,10,FLAT
27,37,2,39,27,34,41,36,17,22,10,27,14,29,24,44,28,22,24,41,10,36,33,55,FLAT
-95,21,99,120,39,27,34,41,27,2,-79,-95,44,24,-69,-68,41,31,-55,-51,55,24,-55,-54,FLAT
44,45,12,57,66,120,39,27,40,30,39,44,-55,-3,60,84,-28,-1,-19,-11,-11,21,-9,16,FLAT
-63,27,116,143,57,66,120,39,44,41,-45,-63,84,71,-6,-19,-11,38,15,21,16,40,-64,-74,FLAT
-131,0,141,141,143,57,66,120,-63,-106,-104,-131,-19,-65,-149,-194,21,-35,-110,-150,-74,-68,-89,-110,FLAT
50,87,12,99,141,143,57,66,-131,-79,-37,50,-194,-185,-141,-81,-150,-144,-186,-144,-110,-114,-147,-100,FLAT
-29,20,38,58,99,141,143,57,50,-3,38,-29,-81,-82,1,21,-144,-188,-103,-110,-100,-147,-148,-173,FLAT
-4,69,20,89,58,99,141,143,-29,-22,-53,-4,21,-25,-15,-33,-110,-104,-52,17,-173,-210,-156,-114,FLAT
72,84,6,90,89,58,99,141,-4,58,57,72,-33,36,4,68,17,33,42,39,-114,-46,5,89,FLAT
2,47,24,71,90,89,58,99,72,20,39,2,68,78,96,74,39,56,43,70,89,53,81,41,FLAT
76,105,11,116,71,90,89,58,2,63,18,76,74,83,57,78,70,141,114,150,41,119,61,146,FLAT
-131,8,131,139,116,71,90,89,76,-11,-34,-131,78,52,-16,-55,150,72,23,-53,146,130,80,19,FLAT
31,38,13,51,139,116,71,90,-131,-87,1,31,-55,-98,-33,-100,-53,-35,-15,-24,19,-15,24,-22,FLAT
66,79,15,94,51,139,116,71,31,68,25,66,-100,-19,26,97,-24,-30,-8,-34,-22,33,10,42,FLAT
10,19,47,66,94,51,139,116,66,42,70,10,97,110,95,76,-34,23,96,107,42,12,62,-24,FLAT
-19,11,41,52,66,94,51,139,10,-25,-11,-19,76,17,59,-9,107,85,84,57,-24,-2,85,88,FLAT
-56,8,65,73,52,66,94,51,-19,-32,-53,-56,-9,-57,-64,-75,57,-15,6,-65,88,53,31,1,FLAT
33,36,16,52,73,52,66,94,-56,-16,5,33,-75,-48,-48,-23,-65,-73,-59,-42,1,-31,11,-32,FLAT
-34,19,37,56,52,73,52,66,33,-13,-17,-34,-23,-29,-12,-1,-42,-61,-65,-57,-32,-86,-76,-76,FLAT
-35,3,35,38,56,52,73,52,-34,-37,-19,-35,-1,-50,-36,-69,-57,-66,-31,-36,-76,-98,-84,-92,FLAT
15,20,24,44,38,56,52,73,-35,4,-2,15,-69,-33,-21,-20,-36,-46,-38,-54,-92,-62,-33,-21,FLAT
47,47,4,51,44,38,56,52,15,27,20,47,-20,31,18,62,-54,-6,-1,27,-21,-19,-18,-7,FLAT
-25,7,34,41,51,44,38,56,47,5,15,-25,62,32,35,22,27,36,33,37,-7,-1,14,2,FLAT
67,73,1,74,41,51,44,38,-25,34,1,67,22,39,16,42,37,66,36,89,2,70,34,104,FLAT
36,62,39,101,74,41,51,44,67,74,47,36,42,108,48,103,89,113,63,78,104,140,83,125,FLAT
-38,35,46,81,101,74,41,51,36,-31,-11,-38,103,43,36,-2,78,77,37,65,125,82,52,40,FLAT
-147,32,162,194,81,101,74,41,-38,-31,-144,-147,-2,-62,-155,-185,65,12,-108,-149,40,46,-107,-82,FLAT
5,35,27,62,194,81,101,74,-147,-130,2,5,-185,-161,-142,-142,-149,-192,-153,-180,-82,-118,-106,-144,FLAT
16,50,54,104,62,194,81,101,5,43,1,16,-142,-87,3,21,-180,-118,-141,-126,-144,-149,-152,-164,FLAT
2,15,46,61,104,62,194,81,16,-6,37,2,21,37,38,18,-126,-93,40,23,-164,-124,-104,-124,FLAT
-104,26,119,145,61,104,62,194,2,-31,-115,-104,18,-37,-78,-102,23,6,-77,-86,-124,-124,-75,-81,FLAT
34,36,61,97,145,61,104,62,-104,-24,24,34,-102,-55,-91,-70,-86,-61,-54,-68,-81,-18,-53,-52,FLAT
131,131,38,169,97,145,61,104,34,108,36,131,-70,84,60,165,-68,53,-55,61,-52,47,-18,63,FLAT
-23,32,26,58,169,97,145,61,131,-35,76,-23,165,73,112,108,61,49,136,142,63,18,21,38,FLAT
65,71,20,91,58,169,97,145,-23,59,26,65,108,24,102,42,142,132,138,173,38,108,162,207,FLAT
-21,32,34,66,91,58,169,97,65,-7,18,-21,42,52,44,44,173,17,120,21,207,125,156,152,FLAT
-6,15,31,46,66,91,58,169,-21,-9,11,-6,44,-16,29,-27,21,43,55,38,152,8,131,15,FLAT
-62,1,76,77,46,66,91,58,-6,-17,-48,-62,-27,-26,-37,-68,38,-33,-19,-89,15,26,7,-24,FLAT
-2,34,25,59,77,46,66,91,-62,-53,-35,-2,-68,-70,-83,-64,-89,-79,-72,-70,-24,-86,-54,-91,FLAT
28,49,4,53,59,77,46,66,-2,7,13,28,-64,-46,-22,26,-70,-63,-70,-36,-91,-72,-59,-42,FLAT
-70,10,73,83,53,59,77,46,28,-1,-31,-70,26,6,-18,-42,-36,-47,-53,-44,-42,-64,-101,-106,FLAT
7,28,14,42,83,53,59,77,-70,-52,-11,7,-42,-53,-42,-63,-44,-46,-29,-35,-106,-99,-64,-37,FLAT
-30,6,58,64,42,83,53,59,7,14,-8,-30,-63,-38,-19,-23,-35,-39,-50,-93,-37,-32,-37,-65,FLAT
-24,8,27,35,64,42,83,53,-30,-55,-26,-24,-23,-41,-34,-54,-93,-93,-45,-47,-65,-94,-76,-117,FLAT
74,85,11,96,35,64,42,83,-24,58,-3,74,-54,3,-29,50,-47,17,-37,20,-117,-35,-48,27,FLAT
14,25,6,31,96,35,64,42,74,9,74,14,50,67,71,88,20,12,45,64,27,26,37,34,FLAT
46,46,1,47,31,96,35,64,14,41,25,46,88,50,99,60,64,108,96,134,34,53,70,110,FLAT
17,30,3,33,47,31,96,35,46,19,33,17,60,60,58,63,134,69,132,77,110,127,129,151,FLAT
15,33,2,35,28,35,30,38,-22,-5,-12,15,2,-9,-9,-7,19,8,3,17,9,15,18,34,FLAT
14,21,11,32,35,28,35,30,15,23,26,14,-7,18,14,29,17,14,17,7,34,31,29,31,FLAT
-5,2,11,13,32,35,28,35,14,-5,14,-5,29,18,40,9,7,13,28,24,31,9,31,2,FLAT
19,27,0,27,13,32,35,28,-5,8,-6,19,9,3,8,14,24,26,34,28,2,21,22,43,FLAT
-6,2,12,14,27,13,32,35,19,6,19,-6,14,14,13,13,28,9,27,8,43,32,53,22,FLAT
-26,1,33,34,14,27,13,32,-6,-5,-25,-26,13,1,-6,-32,8,9,-12,-13,22,4,2,-18,FLAT
31,38,25,63,34,14,27,13,-26,23,-6,31,-32,18,-31,5,-13,24,-12,-1,-18,32,-18,18,FLAT
9,34,3,37,63,34,14,27,31,-13,13,9,5,10,7,40,-1,5,-18,14,18,11,1,8,FLAT
-40,8,48,56,37,63,34,14,9,5,-14,-40,40,-8,-1,-31,14,15,-7,0,8,10,-32,-26,FLAT
-11,37,45,82,58,56,37,63,-26,-3,-27,-11,-66,-40,-66,-37,-57,-35,-80,-77,-26,-48,-67,-68,FLAT
32,43,2,45,82,58,56,37,-11,-11,26,32,-37,-14,-1,21,-77,-51,-40,-5,-68,-46,-54,-45,FLAT
-72,8,73,81,45,82,58,56,32,-1,-37,-72,21,-12,-11,-40,-5,-15,-38,-51,-45,-52,-77,-77,FLAT
43,83,36,119,81,45,82,58,-72,6,-32,43,-40,5,-69,-29,-51,-6,-43,3,-77,-9,-70,-8,FLAT
31,38,70,108,119,81,45,82,43,65,76,31,-29,71,44,74,3,70,7,2,-8,59,33,34,FLAT
-58,3,92,95,108,119,81,45,31,-36,-23,-58,74,29,53,-27,2,35,21,16,34,34,-16,-56,FLAT
93,102,44,146,95,108,119,81,-58,45,-6,93,-27,9,-29,35,16,74,47,66,-56,80,15,109,FLAT
-56,4,65,69,146,95,108,119,93,-35,42,-56,35,10,36,37,66,-26,13,-21,109,39,89,10,FLAT
-38,10,51,61,69,146,95,108,-56,-52,-44,-38,37,-87,-2,-94,-21,-42,-8,-1,10,-78,-31,-59,FLAT
32,55,2,57,61,69,146,95,-38,-17,-13,32,-94,-69,-57,-6,-1,-104,-15,-62,-59,-59,-21,31,FLAT
-25,9,46,55,57,61,69,146,32,19,21,-25,-6,2,8,7,-62,-50,-36,-31,31,-85,6,-87,FLAT
-45,15,51,66,55,57,61,69,-25,-40,-51,-45,7,-21,-30,-70,-31,-38,-43,-38,-87,-90,-87,-76,FLAT
96,98,1,99,66,55,57,61,-45,46,13,96,-70,6,-38,51,-38,25,-17,26,-76,8,-30,58,FLAT
-29,22,30,52,99,66,55,57,96,0,47,-29,51,46,60,67,26,6,9,22,58,25,30,-3,FLAT
13,42,0,42,52,99,66,55,-29,-17,-7,13,67,-17,40,-16,22,29,53,80,-3,-11,2,35,FLAT
-80,0,80,80,42,52,99,66,13,0,-38,-80,-16,-17,-45,-67,80,-17,2,-96,35,29,15,0,FLAT
58,66,1,67,80,42,52,99,-80,-21,-8,58,-67,-21,-46,-22,-96,-38,-53,-9,0,-38,-6,-38,FLAT
23,25,27,52,103,67,80,42,88,40,91,23,146,137,152,111,66,116,144,169,79,116,106,89,FLAT
30,62,4,66,52,103,67,80,23,7,-7,30,111,47,84,53,169,144,145,141,89,123,137,199,FLAT
-26,14,39,53,66,52,103,67,30,9,22,-26,53,16,15,4,141,56,106,27,199,153,167,115,FLAT
80,85,63,148,53,66,52,103,-26,104,9,80,4,113,31,54,27,120,24,84,115,160,115,107,FLAT
2,59,2,61,148,53,66,52,80,-59,28,2,54,45,37,82,84,54,59,56,107,61,52,86,FLAT
-2,27,18,45,61,148,53,66,2,14,30,-2,82,-45,58,0,56,59,67,80,86,68,89,54,FLAT
31,61,17,78,45,61,148,53,-2,30,-3,31,0,44,27,29,80,-15,55,31,54,89,64,111,FLAT
112,128,5,133,269,78,45,61,-248,-148,-12,112,-217,-148,-203,-136,-219,-118,-206,-105,-217,-104,-176,-107,FLAT
-42,1,129,130,133,269,78,45,112,82,85,-42,-136,-66,73,70,-105,-66,-118,-178,-107,-36,-121,-147,FLAT
-61,67,78,145,130,133,269,78,-42,-112,-127,-61,70,-30,-42,-103,-178,-178,-54,9,-147,-178,-245,-239,FLAT
-6,58,39,97,145,130,133,269,-61,-45,3,-6,-103,-157,-124,-67,9,-75,-39,-109,-239,-223,-51,3,FLAT
-82,25,88,113,97,145,130,133,-6,-33,-49,-82,-67,-78,-46,-88,-109,-190,-173,-149,3,-108,-88,-191,FLAT
114,114,66,180,113,97,145,130,-82,92,25,114,-88,59,-24,32,-149,14,-21,26,-191,-98,-148,-35,FLAT
-39,20,91,111,180,113,97,145,114,-14,55,-39,32,78,80,75,26,45,31,-7,-35,0,34,-13,FLAT
-175,6,196,202,111,180,113,97,-39,-70,-161,-175,75,-84,-106,-214,-7,8,-81,-100,-13,-25,-130,-182,FLAT
-75,33,143,176,202,111,180,113,-175,-128,-102,-75,-214,-198,-263,-250,-100,-212,-208,-289,-182,-120,-183,-175,FLAT
-9,18,52,70,176,202,111,180,-75,-100,6,-9,-250,-228,-96,-84,-289,-298,-257,-259,-175,-312,-202,-298,FLAT
-14,13,42,55,70,176,202,111,-9,-24,-9,-14,-84,-124,-3,-23,-259,-252,-105,-98,-298,-322,-266,-273,FLAT
73,73,19,92,52,55,70,176,17,61,21,73,3,67,30,90,-6,43,21,76,-81,-57,27,67,FLAT
67,70,4,74,92,52,55,70,73,52,70,67,90,113,91,140,76,119,100,157,67,95,91,143,FLAT
-12,24,26,50,74,92,52,55,67,10,34,-12,140,62,104,55,157,123,125,128,143,129,134,145,FLAT
50,59,8,67,74,54,50,74,52,36,43,50,21,60,47,102,9,53,36,71,76,63,70,59,FLAT
-28,6,53,59,67,74,54,50,50,17,25,-28,102,53,68,22,71,77,72,74,59,70,61,43,FLAT
39,45,10,55,59,67,74,54,-28,-4,0,39,22,13,25,11,74,49,68,61,43,73,72,113,FLAT
9,32,9,41,55,59,67,74,39,8,22,9,11,4,22,48,61,21,47,20,113,57,90,70,FLAT
8,14,14,28,25,26,27,26,-15,-1,-4,8,-35,-17,-19,-7,-16,-17,-18,-27,-34,-13,-15,-8,FLAT
11,18,8,26,28,25,26,27,8,5,7,11,-7,4,3,19,-27,-12,-12,4,-8,-12,-11,-16,FLAT
-2,3,10,13,26,28,25,26,11,0,13,-2,19,5,20,9,4,4,16,17,-16,-12,1,2,FLAT
21,31,0,31,13,26,28,25,-2,11,-7,21,9,11,6,19,17,16,13,30,2,15,9,38,FLAT
25,30,2,32,31,13,26,28,21,27,26,25,19,38,19,46,30,38,32,44,38,43,39,55,FLAT
8,21,8,29,32,31,13,26,25,14,17,8,46,41,43,33,44,52,36,54,55,52,49,52,FLAT
0,14,4,18,29,32,31,13,8,-4,7,0,33,10,24,8,54,37,50,33,52,48,43,54,FLAT
-2,17,18,35,18,29,32,31,0,12,-5,-2,8,8,2,-2,33,22,19,6,54,49,45,31,FLAT
-3,23,22,45,35,18,29,32,-2,1,-9,-3,-2,13,-14,-5,6,9,-7,-5,31,23,10,3,FLAT
28,29,21,50,45,35,18,29,-3,27,22,28,-5,28,13,25,-5,40,8,23,3,36,15,23,FLAT
36,41,7,48,50,45,35,18,28,22,24,36,25,49,46,64,23,50,37,61,23,62,32,59,FLAT
-32,7,40,47,48,50,45,35,36,1,2,-32,64,23,26,4,61,50,48,32,59,51,39,29,FLAT
-13,42,16,58,54,47,48,50,-31,-45,-49,-13,-63,-68,-79,-44,-27,-67,-77,-76,1,-45,-53,-40,FLAT
0,36,36,72,58,54,47,48,-13,20,6,0,-44,-25,-43,-13,-76,-48,-73,-44,-40,-47,-71,-76,FLAT
-49,22,55,77,72,58,54,47,0,-30,-35,-49,-13,-10,-29,-49,-44,-55,-78,-62,-76,-78,-108,-93,FLAT
-21,36,26,62,77,72,58,54,-49,-50,-35,-21,-49,-80,-70,-70,-62,-60,-64,-70,-93,-105,-113,-83,FLAT
-61,66,73,139,62,77,72,58,-21,-14,-91,-61,-70,-64,-126,-82,-70,-94,-161,-131,-83,-74,-155,-131,FLAT
51,56,3,59,139,62,77,72,-61,-19,61,51,-82,-33,-30,-10,-131,-83,-65,-31,-131,-113,-100,-80,FLAT
0,16,15,31,59,139,62,77,51,12,40,0,-10,-7,101,51,-31,-21,10,-10,-80,-71,-25,-31,FLAT
-79,7,79,86,55,31,59,139,-31,-43,-74,-79,-31,-46,-101,-110,20,-34,-61,-110,-41,-53,0,-59,FLAT
-6,21,36,57,86,55,31,59,-79,-49,-20,-6,-110,-92,-94,-85,-110,-95,-121,-116,-59,-83,-81,-116,FLAT
8,11,27,38,57,86,55,31,-6,-1,18,8,-85,-50,-2,2,-116,-93,-76,-77,-116,-96,-103,-108,FLAT
-2,29,28,57,38,57,86,55,8,-1,-20,-2,2,-2,-2,6,-77,-51,-22,0,-108,-94,-96,-79,FLAT
-15,1,34,35,57,38,57,86,-2,-9,13,-15,6,-10,-7,-17,0,-11,11,-9,-79,-60,-9,-15,FLAT
-3,3,18,21,35,57,38,57,-15,-19,-5,-3,-17,-28,8,-18,-9,-29,-12,-20,-15,-30,6,-12,FLAT
-22,1,57,58,21,35,57,38,-3,17,-20,-22,-18,-2,-25,-25,-20,-11,-12,-40,-12,-12,-32,-42,FLAT
30,30,1,31,58,21,35,57,-22,-26,1,30,-25,-9,-19,8,-40,-28,-24,5,-42,-37,-11,-10,FLAT
33,39,0,39,31,58,21,35,30,32,24,33,8,6,25,63,5,23,5,41,-10,4,0,38,FLAT
0,20,7,27,39,31,58,21,33,7,19,0,63,39,43,33,41,13,44,63,38,30,24,41,FLAT
-3,15,10,25,27,39,31,58,0,0,2,-3,33,7,21,-3,63,39,45,30,41,13,46,60,FLAT
-76,1,82,83,25,27,39,31,-3,-4,-62,-76,-3,-4,-60,-79,30,3,-41,-79,60,35,-17,-46,FLAT
26,29,18,47,83,25,27,39,-76,-38,-2,26,-79,-42,-64,-50,-79,-42,-62,-53,-46,-35,-43,-53,FLAT
-6,11,14,25,47,83,25,27,26,-10,12,-6,-50,-48,10,20,-53,-52,-52,-56,-53,-52,-50,-59,FLAT
-14,12,24,36,25,47,83,25,-6,-4,-15,-14,20,-14,-3,-20,-56,-52,-5,6,-59,-56,-67,-70,FLAT
37,50,3,53,36,25,47,83,-14,16,-1,37,-20,12,-16,23,6,2,-4,17,-70,-36,-6,43,FLAT
-1,20,11,31,53,36,25,47,37,7,29,-1,23,23,28,36,17,19,13,22,43,9,25,16,FLAT
-23,37,23,60,31,53,36,25,-1,-11,-40,-23,36,-4,-11,-24,22,12,-12,13,16,8,-27,-1,FLAT
-39,0,44,44,60,31,53,36,-23,-18,-2,-39,-24,-29,-42,-62,13,-22,-13,-63,-1,-6,-14,-26,FLAT
11,17,21,38,44,60,31,53,-39,-12,-6,11,-62,-30,-8,-28,-63,-41,-48,-51,-26,-34,-19,-52,FLAT
-11,1,23,24,38,44,60,31,11,-9,5,-11,-28,-21,-1,0,-51,-39,-3,-39,-52,-50,-43,-62,FLAT
0,26,13,39,24,38,44,60,-11,-10,-25,0,0,-19,-20,-11,-39,-31,-26,0,-62,-49,-28,-39,FLAT
-24,1,27,28,39,24,38,44,0,-10,1,-24,-11,-20,-24,-24,0,-29,-19,-35,-39,-41,-25,-24,FLAT
26,26,12,38,28,39,24,38,-24,11,1,26,-24,1,2,2,-35,-9,-23,2,-24,-18,-18,-9,FLAT
16,19,12,31,38,28,39,24,26,16,23,16,2,27,24,42,2,17,25,18,-9,7,0,18,FLAT
-21,0,28,28,31,38,28,39,16,-5,-2,-21,42,11,21,-5,18,22,22,21,18,12,23,-3,FLAT
44,44,0,44,28,31,38,28,-21,16,0,44,-5,11,-2,23,21,27,21,39,-3,38,22,65,FLAT
13,14,13,27,44,28,31,38,44,26,43,13,23,42,43,57,39,37,41,36,65,53,64,52,FLAT
-6,12,8,20,27,44,28,31,13,-11,-4,-6,57,15,39,7,36,31,39,51,52,26,37,30,FLAT
-10,11,14,25,20,27,44,28,-6,-4,-9,-10,7,-15,-13,-16,51,11,30,-3,30,27,30,41,FLAT
8,11,4,15,25,20,27,44,-10,-2,8,8,-16,-6,-1,-2,-3,-17,-5,-8,41,9,38,5,FLAT
-4,1,11,12,15,25,20,27,8,3,6,-4,-2,1,14,4,-8,-3,5,-6,5,-14,1,-12,FLAT
10,10,12,22,12,15,25,20,-4,11,1,10,4,14,7,6,-6,12,15,14,-12,8,6,4,FLAT
-13,2,14,16,22,12,15,25,10,-11,-5,-13,6,0,-4,-3,14,3,2,-7,4,1,10,1,FLAT
7,9,1,10,16,22,12,15,-13,-6,0,7,-3,-17,-5,-6,-7,-6,-4,4,1,-3,2,0,FLAT
-13,4,14,18,10,16,22,12,7,0,-8,-13,-6,-6,-8,-6,4,-17,-13,-19,0,-6,-12,-9,FLAT
6,12,14,26,72,77,79,26,-23,-4,42,6,-84,-69,-18,-17,-153,-138,-85,-78,-139,-143,-143,-147,FLAT
2,30,9,39,26,72,77,79,6,-3,-16,2,-17,-7,26,8,-78,-72,-34,-15,-147,-141,-101,-76,FLAT
-15,18,27,45,39,26,72,77,2,3,-3,-15,8,0,-19,-13,-15,-4,23,-7,-76,-69,-37,-30,FLAT
8,13,7,20,45,39,26,72,-15,-12,13,8,-13,-9,10,-7,-7,-12,-6,-5,-30,-16,36,1,FLAT
19,20,8,28,20,45,39,26,8,20,12,19,-7,8,25,27,-5,11,22,12,1,8,6,14,FLAT
-45,9,48,57,28,20,45,39,19,-5,-34,-45,27,15,-22,-26,12,3,-9,-18,14,6,-12,-33,FLAT
-37,12,68,80,208,57,28,20,-120,-99,29,-37,-165,-137,-160,-157,-146,-142,-194,-202,-138,-122,-182,-183,FLAT
-18,48,18,66,80,208,57,28,-37,-68,-54,-18,-157,-167,-25,-55,-202,-205,-214,-175,-183,-210,-248,-220,FLAT
13,28,15,43,57,66,80,208,7,-11,3,13,-11,17,40,20,-48,-51,-14,2,-168,-150,15,-35,FLAT
59,62,26,88,43,57,66,80,13,70,25,59,20,59,28,72,2,87,65,79,-35,19,11,61,FLAT
6,8,38,46,88,43,57,66,59,18,60,6,72,88,85,65,79,77,88,78,61,105,125,85,FLAT
-76,49,126,175,113,46,88,43,-95,-45,-107,-76,-89,-83,-212,-171,-30,-65,-152,-165,-17,5,-127,-106,FLAT
0,30,34,64,105,104,175,113,71,28,69,0,130,105,145,71,54,38,149,130,-41,-7,42,54,FLAT
70,72,44,116,64,105,104,175,0,80,28,70,71,108,97,70,130,185,173,141,54,118,177,200,FLAT
67,84,3,87,116,64,105,104,70,26,55,67,70,106,83,137,141,134,152,137,200,211,228,208,FLAT
5,33,37,70,87,116,64,105,67,39,56,5,137,65,111,72,137,145,139,142,208,173,208,142,FLAT
-45,29,53,82,70,87,116,64,5,-29,-41,-45,72,10,15,-40,142,36,70,27,142,116,98,97,FLAT
158,158,17,175,82,70,87,116,-45,122,29,158,-40,93,-12,113,27,132,44,118,97,158,99,185,FLAT
45,61,4,65,175,82,70,87,158,32,142,45,113,154,171,203,118,125,130,158,185,164,186,163,FLAT
-8,11,52,63,65,175,82,70,45,40,42,-8,203,72,184,37,158,194,213,195,163,165,172,150,FLAT
103,105,20,125,63,65,175,82,-8,71,9,103,37,111,51,95,195,143,193,140,150,265,222,298,FLAT
-36,2,68,70,125,63,65,175,103,12,67,-36,95,83,76,67,140,123,118,59,298,155,260,104,FLAT
80,87,17,104,70,125,63,65,-36,29,-5,80,67,41,62,44,59,112,71,147,104,152,113,139,FLAT
-26,29,31,60,104,70,125,63,80,-12,32,-26,44,17,27,54,147,29,94,18,139,100,103,121,FLAT
58,61,6,67,60,104,70,125,-26,33,26,58,54,21,58,32,18,50,53,112,121,62,120,76,FLAT
-47,21,53,74,67,60,104,70,58,0,-7,-47,32,33,19,11,112,21,51,-15,76,50,46,65,FLAT
41,57,50,107,74,67,60,104,-47,38,5,41,11,38,-2,-6,-15,71,24,52,65,59,56,26,FLAT
71,95,8,103,107,74,67,60,41,29,33,71,-6,67,38,112,52,67,31,65,26,100,57,123,FLAT
-10,19,36,55,103,107,74,67,71,18,66,-10,112,47,99,61,65,85,104,102,123,85,97,55,FLAT
-70,26,80,106,55,103,107,74,-10,-26,-77,-70,61,-8,-11,-80,102,21,22,-9,55,59,27,32,FLAT
-19,13,38,51,106,55,103,107,-70,-61,-6,-19,-80,-87,-83,-89,-9,-69,-17,-99,32,-40,16,-28,FLAT
-118,7,118,125,51,106,55,103,-19,-38,-112,-118,-89,-99,-118,-137,-99,-125,-195,-207,-28,-107,-129,-217,FLAT
99,137,31,168,125,51,106,55,-118,12,-31,99,-137,-26,-143,-19,-207,-87,-149,-38,-217,-113,-226,-108,FLAT
14,16,51,67,168,125,51,106,99,34,135,14,-19,46,104,113,-38,8,-8,-5,-108,-53,-14,-24,FLAT
-49,20,71,91,67,168,125,51,14,-29,-53,-49,113,5,82,-35,-5,17,51,64,-24,-21,-61,-54,FLAT
14,39,38,77,91,67,168,125,-49,-19,-5,14,-35,-48,-58,-35,64,-14,77,-21,-54,-2,46,78,FLAT
-17,55,68,123,77,91,67,168,14,13,-33,-17,-35,-6,-38,-3,-21,-35,-91,-52,78,-1,44,-38,FLAT
-2,78,19,97,123,77,91,67,-17,-51,-25,-2,-3,-38,-58,-19,-52,-57,-63,-5,-38,-86,-116,-54,FLAT
30,40,96,136,97,123,77,91,-2,107,68,30,-19,56,43,28,-5,69,10,11,-54,50,5,25,FLAT
-35,20,38,58,136,97,123,77,30,-93,-15,-35,28,14,53,-5,11,-37,28,-7,25,-24,-5,-24,FLAT
-38,17,48,65,58,136,97,123,-35,-28,-35,-38,-5,-121,-50,-73,-7,-14,18,-43,-24,-65,-7,-45,FLAT
-13,28,32,60,65,58,136,97,-38,-29,-24,-13,-73,-57,-59,-51,-43,-150,-74,-86,-45,-43,-6,-56,FLAT
3,9,37,46,60,65,58,136,-13,8,22,3,-51,-21,-2,-10,-86,-49,-37,-48,-56,-142,-52,-83,FLAT
-13,17,21,38,46,60,65,58,3,-29,-21,-13,-10,-21,1,-10,-48,-50,-23,-23,-83,-78,-58,-61,FLAT
15,69,5,74,38,46,60,65,-13,-1,-37,15,-10,-30,-58,2,-23,-22,-36,5,-61,-51,-60,-8,FLAT
20,22,22,44,74,38,46,60,15,37,67,20,2,36,30,35,5,7,9,22,-8,15,31,25,FLAT
-20,3,42,45,44,74,38,46,20,0,-1,-20,35,37,66,0,22,36,29,15,25,7,8,2,FLAT
-23,0,59,59,45,44,74,38,-20,-6,-20,-23,0,-6,-21,-43,15,31,46,-23,2,30,9,-8,FLAT
-41,24,50,74,59,45,44,74,-23,-50,-65,-41,-43,-56,-85,-64,-23,-56,-86,-84,-8,-19,-19,-64,FLAT
-2,12,29,41,74,59,45,44,-41,-23,10,-2,-64,-73,-55,-43,-84,-79,-75,-66,-64,-79,-76,-86,FLAT
17,38,13,51,41,74,59,45,-2,1,-9,17,-43,-22,1,15,-66,-72,-64,-26,-86,-78,-84,-49,FLAT
-12,6,22,28,51,41,74,59,17,-3,20,-12,15,-2,11,5,-26,-25,21,3,-49,-75,-44,-38,FLAT
-21,12,26,38,59,42,60,27,14,2,23,-21,9,14,18,-7,-46,-45,-23,-12,-53,-48,-59,-67,FLAT
10,37,4,41,38,59,42,60,-21,-12,-15,10,-7,-10,8,-11,-12,2,3,3,-67,-57,-38,-2,FLAT
-2,4,21,25,41,38,59,42,10,15,31,-2,-11,3,16,8,3,5,39,-13,-2,17,34,1,FLAT
-5,0,21,21,25,41,38,59,-2,-5,-1,-5,8,10,30,-7,-13,-2,15,3,1,0,38,-18,FLAT
-1,29,18,47,21,25,41,38,-5,-4,-30,-1,-7,-9,-31,-6,3,6,0,-8,-18,-6,-15,2,FLAT
-28,10,28,38,47,21,25,41,-1,-18,-9,-28,-6,-22,-39,-29,-8,-27,-40,-34,2,-12,-9,-36,FLAT
-10,33,46,79,38,47,21,25,-28,8,-33,-10,-29,-10,-42,-38,-34,-14,-72,-39,-36,-19,-73,-44,FLAT
-31,62,32,94,79,38,47,21,-10,-45,-60,-31,-38,-37,-93,-41,-39,-55,-102,-69,-44,-59,-132,-70,FLAT
62,71,16,87,94,79,38,47,-31,46,53,62,-41,1,-7,31,-69,9,-40,21,-70,-9,-49,-7,FLAT
-70,19,77,96,87,94,79,38,62,-9,-18,-70,31,37,35,-8,21,-8,-25,-39,-7,0,-58,-49,FLAT
-45,8,114,122,96,87,94,79,-70,-8,-34,-45,-8,-17,-52,-115,-39,29,1,-53,-49,-16,-59,-84,FLAT
5,31,47,78,122,96,87,94,-45,-62,-18,5,-115,-70,-52,-40,-53,-79,-70,-110,-84,-33,-17,-48,FLAT
-15,55,36,91,78,122,96,87,5,-26,-39,-15,-40,-88,-57,-10,-110,-96,-91,-55,-48,-105,-109,-125,FLAT
-75,34,75,109,91,78,122,96,-15,-36,-54,-75,-10,-62,-93,-90,-55,-124,-111,-85,-125,-132,-145,-130,FLAT
9,64,25,89,109,91,78,122,-75,-41,-21,9,-90,-77,-75,-66,-85,-103,-114,-81,-130,-165,-132,-76,FLAT
-55,3,78,81,89,109,91,78,9,-2,6,-55,-66,-43,-15,-46,-81,-79,-69,-121,-76,-105,-108,-136,FLAT
14,44,34,78,81,89,109,91,-55,-30,-27,14,-46,-32,-21,-41,-121,-73,-42,-32,-136,-109,-96,-107,FLAT
-76,9,105,114,78,81,89,109,14,-5,-41,-76,-41,-35,-68,-62,-32,-37,-62,-117,-107,-78,-83,-108,FLAT
38,42,23,65,114,78,81,89,-76,-44,5,38,-62,-49,-36,-38,-117,-79,-63,-24,-108,-81,-57,-79,FLAT
-55,29,64,93,65,114,78,81,38,-14,-42,-55,-38,-58,-37,-17,-24,-63,-78,-93,-79,-93,-105,-79,FLAT
-53,11,58,69,93,65,114,78,-55,-59,-35,-53,-17,-73,-77,-108,-93,-117,-72,-70,-79,-122,-113,-146,FLAT
21,47,18,65,135,105,69,93,93,25,95,21,128,62,102,114,75,109,113,149,20,50,78,96,FLAT
15,60,1,61,65,135,105,69,21,-2,2,15,114,23,97,36,149,60,104,129,96,107,115,164,FLAT
-53,7,56,63,61,65,135,105,15,2,0,-53,36,0,2,-38,129,25,97,-17,164,62,104,76,FLAT
14,46,6,52,63,61,65,135,-53,-36,-25,14,-38,-34,-25,-39,-17,-36,-23,-24,76,-11,72,-3,FLAT
51,51,16,67,52,63,61,65,14,61,46,51,-39,25,21,65,-24,27,21,12,-3,25,23,27,FLAT
-9,32,25,57,67,52,63,61,51,0,10,-9,65,61,56,42,12,25,31,56,27,27,31,3,FLAT
10,26,33,59,57,67,52,63,-9,18,16,10,42,18,26,1,56,79,72,52,3,43,47,66,FLAT
49,51,5,56,59,57,67,52,10,21,24,49,1,39,40,59,52,39,50,50,66,100,96,101,FLAT
-5,2,55,57,56,59,57,67,49,45,44,-5,59,66,68,44,50,84,84,54,101,84,94,45,FLAT
-20,8,43,51,57,56,59,57,-5,-32,-26,-20,44,13,18,-25,54,34,42,24,45,52,58,34,FLAT
71,77,1,78,51,57,56,59,-20,29,2,71,-25,-3,-24,51,24,42,20,46,34,63,44,95,FLAT
-44,26,50,76,78,51,57,56,71,5,7,-44,51,34,9,27,46,2,-17,7,95,47,27,2,FLAT
27,55,8,63,76,78,51,57,-44,-15,-2,27,27,-10,5,-17,7,19,7,54,2,-13,-19,34,FLAT
-45,7,63,70,63,76,78,51,27,10,3,-45,-17,-5,1,-18,54,0,8,-62,34,29,10,9,FLAT
32,56,30,86,70,63,76,78,-45,-1,-17,32,-18,9,-14,-13,-62,-6,-16,14,9,-1,-9,-30,FLAT
20,42,16,58,86,70,63,76,32,6,34,20,-13,5,17,52,14,15,20,7,-30,0,18,34,FLAT
130,135,65,200,58,86,70,63,20,179,37,130,52,185,71,150,7,184,54,182,34,194,57,137,FLAT
10,62,17,79,288,129,200,58,-284,-261,-52,10,-357,-365,-315,-274,-227,-395,-274,-347,-207,-216,-237,-217,FLAT
125,126,84,210,79,288,129,200,10,192,61,125,-274,-69,9,135,-347,-173,-254,-149,-217,-203,-213,-222,FLAT
-154,38,154,192,210,79,288,129,125,-84,-66,-154,135,108,-5,-29,-149,-153,-57,-19,-222,-257,-320,-303,FLAT
-36,27,64,91,192,210,79,288,-154,-126,-25,-36,-29,-210,-91,-190,-19,-18,-30,-65,-303,-279,-82,-55,FLAT
-22,46,44,90,91,192,210,79,-36,-42,-41,-22,-190,-168,-66,-58,-65,-252,-132,-212,-55,-60,-71,-87,FLAT
97,98,21,119,90,91,192,210,-22,74,45,97,-58,32,4,75,-212,-94,-21,39,-87,-178,-87,-115,FLAT
-125,6,142,148,119,90,91,192,97,-4,-33,-125,75,70,12,-28,39,28,-29,-50,-115,-98,-54,-86,FLAT
20,45,20,65,142,148,119,90,-93,-70,7,20,-218,-195,-112,-73,-121,-199,-145,-198,-143,-125,-100,-101,FLAT
-91,1,107,108,65,142,148,119,20,-4,-47,-91,-73,-74,-40,-71,-198,-199,-159,-164,-101,-203,-192,-289,FLAT
17,29,15,44,108,65,142,148,-91,-75,-11,17,-71,-79,-58,-74,-164,-149,-51,-54,-289,-274,-170,-147,FLAT
184,187,17,204,92,87,44,108,78,192,80,184,103,243,126,262,120,289,129,287,29,214,118,304,FLAT
-35,9,68,77,204,92,87,44,184,16,143,-35,262,208,223,149,287,259,269,227,304,305,272,252,FLAT
-24,16,27,43,28,30,44,33,-6,-14,-29,-24,-26,-24,-37,-30,-11,-38,-37,-50,-11,-21,-31,-35,FLAT
-26,6,27,33,43,28,30,44,-24,-26,-16,-26,-30,-40,-45,-50,-50,-50,-53,-56,-35,-64,-53,-76,FLAT
65,66,6,72,33,43,28,30,-26,44,5,65,-50,18,-11,39,-56,4,-40,15,-76,-6,-48,9,FLAT
-35,4,42,46,72,33,43,28,65,1,27,-35,39,45,32,30,15,19,16,4,9,5,-13,-20,FLAT
-58,5,74,79,46,72,33,43,-35,-26,-59,-58,30,-25,-32,-93,4,19,-27,-28,-20,-7,-43,-54,FLAT
-10,20,42,62,79,46,72,33,-58,-42,-25,-10,-93,-68,-84,-68,-28,-67,-57,-103,-54,-23,-52,-38,FLAT
12,18,7,25,62,79,46,72,-10,-23,14,12,-68,-65,-11,2,-103,-91,-70,-56,-38,-90,-43,-91,FLAT
-23,18,31,49,25,62,79,46,12,1,-23,-23,2,-22,-9,-11,-56,-64,-34,-21,-91,-90,-93,-79,FLAT
-23,13,32,45,49,25,62,79,-23,-22,-18,-23,-11,-21,-41,-46,-21,-44,-27,-34,-79,-86,-52,-44,FLAT
-3,36,40,76,45,49,25,62,-23,5,-26,-3,-46,-17,-44,-26,-34,-16,-67,-49,-44,-39,-53,-37,FLAT
29,39,34,73,76,45,49,25,-3,23,26,29,-26,28,0,26,-49,6,-18,3,-37,7,-41,-20,FLAT
-9,44,26,70,73,76,45,49,29,-17,-14,-9,26,6,12,20,3,11,-14,17,-20,-11,-32,-6,FLAT
52,70,13,83,70,73,76,45,-9,39,26,52,20,22,12,43,17,45,38,72,-6,50,12,69,FLAT
7,50,19,69,83,70,73,76,52,13,27,7,43,52,53,59,72,35,39,50,69,58,65,79,FLAT
-93,12,124,136,135,69,83,70,-126,-101,-102,-93,-119,-114,-181,-219,-67,-101,-154,-212,-76,-62,-128,-160,FLAT
-9,50,27,77,77,136,135,69,75,17,17,-9,-18,-31,28,66,-144,-132,-74,-27,-137,-145,-153,-153,FLAT
60,88,1,89,77,77,77,136,50,42,30,60,41,84,72,110,116,101,89,101,23,53,100,176,FLAT
63,66,2,68,89,77,77,77,60,64,85,63,110,106,115,123,101,148,157,173,176,165,174,164,FLAT
40,82,2,84,68,89,77,77,63,40,24,40,123,104,109,103,173,146,139,163,164,188,181,213,FLAT
-2,26,40,66,84,68,89,77,40,36,54,-2,103,76,78,38,163,140,163,101,213,182,193,161,FLAT
41,61,0,61,66,84,68,89,-2,1,6,41,38,37,60,39,101,77,84,79,161,141,169,142,FLAT
140,143,9,152,61,66,84,68,41,149,58,140,39,150,64,181,79,186,118,179,142,226,142,219,FLAT
-53,9,64,73,152,61,66,84,140,2,81,-53,181,151,139,87,179,152,145,128,219,188,199,126,FLAT
8,36,80,116,73,152,61,66,-53,24,-19,8,87,26,62,-45,128,175,120,95,126,176,126,136,FLAT
76,76,30,106,116,73,152,61,8,26,36,76,-45,50,17,84,95,52,98,31,136,201,156,171,FLAT
-30,24,50,74,106,116,73,152,76,-10,22,-30,84,16,58,46,31,40,39,54,171,42,120,1,FLAT
41,42,28,70,74,106,116,73,-30,19,23,41,46,9,45,11,54,35,81,87,1,59,62,95,FLAT
-42,1,50,51,70,74,106,116,41,-20,-1,-42,11,-1,22,-1,87,-11,44,-31,95,15,80,45,FLAT
53,55,5,60,51,70,74,106,-42,8,-1,53,-1,-12,-2,11,-31,7,21,52,45,-3,43,22,FLAT
-79,12,79,91,60,51,70,74,53,-5,-36,-79,11,3,-37,-26,52,-17,-38,-68,22,2,-15,-27,FLAT
-32,83,88,171,122,91,60,51,-101,-56,-105,-32,-180,-124,-204,-133,-127,-129,-240,-212,-169,-121,-241,-159,FLAT
-28,22,82,104,107,189,171,122,60,18,21,-28,151,40,125,32,119,117,184,123,18,61,79,91,FLAT
71,92,4,96,104,107,189,171,-28,-7,1,71,32,11,22,43,123,33,126,103,91,110,185,194,FLAT
101,107,56,163,96,104,107,189,71,153,86,101,43,146,87,172,103,164,108,144,194,186,212,204,FLAT
62,93,29,122,163,96,104,107,101,35,76,62,172,188,162,163,144,181,163,234,204,199,184,206,FLAT
-45,27,179,206,122,163,96,104,62,105,21,-45,163,140,97,17,234,293,183,118,206,286,184,189,FLAT
20,50,37,87,206,122,163,96,-45,-122,-3,20,17,-17,18,-25,118,18,94,37,189,171,180,138,FLAT
11,36,49,85,98,87,206,122,45,50,63,11,65,68,70,56,20,-54,67,76,82,51,88,31,FLAT
68,104,19,123,85,98,87,206,11,38,0,68,56,88,63,79,76,106,70,124,31,-16,67,144,FLAT
-16,44,39,83,123,85,98,87,68,4,44,-16,79,42,44,52,124,92,107,63,144,110,114,108,FLAT
78,87,34,121,83,123,85,98,-16,73,35,78,52,77,79,62,63,115,79,130,108,165,142,141,FLAT
62,78,28,106,121,83,123,85,78,56,71,62,62,129,106,140,130,133,150,124,141,171,150,192,FLAT
1,34,17,51,106,121,83,123,62,-10,45,1,140,46,116,63,124,119,151,141,192,123,195,125,FLAT
28,37,0,37,51,106,121,83,1,11,25,28,63,1,70,29,141,57,141,91,125,130,176,169,FLAT
66,71,0,71,37,51,106,121,28,66,32,66,29,77,57,94,91,67,102,95,169,123,173,157,FLAT
-5,16,42,58,71,37,51,106,66,37,50,-5,94,103,82,61,95,114,107,89,157,104,152,90,FLAT
-22,16,40,56,58,71,37,51,-5,-24,-22,-22,61,13,28,-27,89,79,60,39,90,90,85,67,FLAT
29,50,8,58,56,58,71,37,-22,-3,-5,29,-27,-27,-27,7,39,10,23,2,67,76,55,68,FLAT
-17,16,25,41,58,56,58,71,29,0,17,-17,7,-3,12,12,2,-27,-10,-10,68,10,40,-15,FLAT
52,52,4,56,41,58,56,58,-17,31,16,52,12,31,33,35,-10,28,28,64,-15,4,6,42,FLAT
25,25,5,30,46,32,27,33,-23,7,23,25,-4,-5,-3,2,3,19,16,21,7,15,18,28,FLAT
-11,10,11,21,30,46,32,27,25,-5,4,-11,2,2,27,14,21,-10,1,-9,28,14,20,10,FLAT
9,18,6,24,21,30,46,32,-11,4,1,9,14,-1,5,-2,-9,6,28,23,10,-6,2,0,FLAT
-34,2,39,41,24,21,30,46,9,-1,-18,-34,-2,3,-17,-25,23,-2,-13,-36,0,5,10,-11,FLAT
-14,12,26,38,41,24,21,30,-34,-27,-24,-14,-25,-28,-42,-48,-36,-24,-41,-39,-11,-29,-37,-50,FLAT
41,55,2,57,38,41,24,21,-14,17,-2,41,-48,-10,-26,27,-39,-11,-44,-7,-50,-7,-43,2,FLAT
-31,1,34,35,57,38,41,24,41,1,23,-31,27,18,21,10,-7,-9,-3,-4,2,-10,-21,-38,FLAT
49,50,12,62,35,57,38,41,-31,27,0,49,10,28,23,18,-4,45,21,59,-38,18,-3,45,FLAT
24,26,8,34,62,35,57,38,49,20,48,24,18,47,48,73,59,48,71,42,45,65,69,83,FLAT
29,39,47,86,34,62,35,57,24,68,16,29,73,88,64,53,42,115,64,102,83,116,87,71,FLAT
-38,5,62,67,86,34,62,35,29,-23,-4,-38,53,45,12,-9,102,65,60,15,71,92,60,64,FLAT
20,20,18,38,67,86,34,62,-38,-24,5,20,-9,-47,1,-18,15,21,17,11,64,41,65,35,FLAT
-15,49,15,64,38,67,86,34,20,-18,-44,-15,-18,-42,-39,5,11,-65,-43,-33,35,3,-27,-4,FLAT
-11,23,49,72,64,38,67,86,-15,23,15,-11,5,5,-29,-26,-33,-19,-24,-6,-4,-42,-28,-44,FLAT
41,41,0,41,72,64,38,67,-11,-8,23,41,-26,15,38,30,-6,-3,-6,15,-44,-27,-1,35,FLAT
-119,13,140,153,41,72,64,38,41,21,-91,-119,30,13,-68,-78,15,36,-53,-89,35,18,-97,-104,FLAT
-3,18,42,60,153,41,72,64,-119,-101,-8,-3,-78,-80,-99,-122,-89,-88,-76,-81,-104,-65,-61,-92,FLAT
11,29,32,61,60,153,41,72,-3,1,0,11,-122,-100,-8,8,-81,-79,-99,-111,-92,-87,-76,-70,FLAT
32,57,18,75,61,60,153,41,11,18,4,32,8,19,4,43,-111,-82,-4,40,-70,-61,-95,-79,FLAT
56,56,20,76,75,61,60,153,32,58,57,56,43,76,61,88,40,77,61,99,-79,-24,53,96,FLAT
25,65,29,94,76,75,61,60,56,34,16,25,88,92,73,81,99,110,77,113,96,111,77,124,FLAT
-52,31,57,88,94,76,75,61,25,-24,-18,-52,81,10,-2,-27,113,68,55,29,124,86,59,61,FLAT
-49,2,129,131,88,94,76,75,-52,23,-20,-49,-27,-1,-38,-101,29,33,-22,-76,61,91,35,-20,FLAT
-8,30,42,72,131,88,94,76,-49,-95,-36,-8,-101,-72,-56,-57,-76,-96,-74,-109,-20,-62,-58,-84,FLAT
39,40,30,70,72,131,88,94,-8,27,29,39,-57,-68,-7,31,-109,-45,-27,-18,-84,-69,-45,-70,FLAT
36,45,11,56,70,72,131,88,39,17,31,36,31,44,60,75,-18,-51,24,67,-70,-28,4,18,FLAT
-15,11,34,45,56,70,72,131,36,8,19,-15,75,25,50,21,67,52,79,60,18,-43,43,52,FLAT
55,55,0,55,45,56,70,72,-15,21,11,55,21,29,30,40,60,46,61,76,52,73,90,115,FLAT
-75,18,75,93,55,45,56,70,55,0,-38,-75,40,21,-27,-20,76,29,-8,-35,115,46,23,1,FLAT
4,38,0,38,43,93,55,45,-10,-26,-21,4,-85,-81,-26,-6,-30,-81,-64,-81,-45,-60,-53,-26,FLAT
0,24,16,40,38,43,93,55,4,16,14,0,-6,-10,-7,4,-81,-65,-12,-6,-26,-65,-50,-81,FLAT
-90,1,91,92,40,38,43,93,0,-15,-67,-90,4,1,-53,-90,-6,-25,-74,-86,-81,-80,-79,-96,FLAT
32,32,45,77,92,40,38,43,-90,-14,1,32,-90,-29,-66,-58,-86,-13,-52,-58,-96,-39,-73,-54,FLAT
23,58,22,80,77,92,40,38,32,0,-3,23,-58,-14,-2,55,-58,-29,-69,-35,-54,-13,-55,-35,FLAT
-154,131,197,328,80,77,92,40,23,21,-227,-154,55,21,-230,-131,-35,7,-229,-99,-35,-8,-296,-189,FLAT
-4,111,34,145,328,80,77,92,-154,-167,16,-4,-131,-146,-211,-158,-99,-146,-214,-135,-189,-160,-213,-103,FLAT
132,137,11,148,175,145,328,80,66,51,78,132,62,175,172,198,-92,8,188,194,-69,29,-39,40,FLAT
-107,0,146,146,148,175,145,328,132,28,30,-107,198,79,108,25,194,203,202,91,40,36,218,87,FLAT
-18,3,94,97,167,146,148,175,-144,-73,-3,-18,-251,-214,-165,-162,-119,-186,-135,-269,-53,-135,-57,-137,FLAT
-121,49,141,190,97,167,146,148,-18,-74,-167,-121,-162,-147,-170,-139,-269,-288,-332,-283,-137,-260,-302,-390,FLAT
37,83,23,106,190,97,167,146,-121,-81,3,37,-139,-155,-164,-84,-283,-228,-167,-102,-390,-369,-329,-246,FLAT
-86,21,97,118,106,190,97,167,37,-12,-24,-86,-84,-93,-21,-49,-102,-167,-188,-170,-246,-240,-191,-188,FLAT
55,72,10,82,118,106,190,97,-86,-32,4,55,-49,-44,-20,-31,-170,-125,-17,6,-188,-199,-184,-115,FLAT
3,40,7,47,82,118,106,190,55,0,35,3,-31,-32,39,58,6,-44,15,-28,-115,-125,18,9,FLAT
-66,8,70,78,47,82,118,106,3,-3,-34,-66,58,-3,1,-63,-28,-35,5,-8,9,-47,-19,-94,FLAT
6,56,5,61,78,47,82,118,-66,-59,-42,6,-63,-62,-76,-60,-8,-62,-41,-57,-94,-94,-37,-2,FLAT
-61,29,67,96,61,78,47,82,6,1,-34,-61,-60,-58,-76,-55,-57,-61,-110,-121,-2,-61,-75,-118,FLAT
-37,29,42,71,96,61,78,47,-61,-62,-37,-37,-55,-61,-71,-98,-121,-120,-113,-92,-118,-123,-147,-158,FLAT
-2,8,36,44,71,96,61,78,-37,-8,19,-2,-98,-70,-18,-39,-92,-69,-52,-100,-158,-128,-94,-94,FLAT
-33,12,33,45,44,71,96,61,-2,-36,-37,-33,-39,-44,-18,-35,-100,-106,-55,-72,-94,-105,-89,-133,FLAT
22,47,13,60,45,44,71,96,-33,2,-13,22,-35,-34,-50,-11,-72,-42,-31,-13,-133,-104,-68,-50,FLAT
34,51,4,55,60,45,44,71,22,25,30,34,-11,27,17,56,-13,-9,-20,23,-50,-17,-1,21,FLAT
-76,0,80,80,55,60,45,44,34,0,-25,-76,56,25,5,-42,23,27,-8,-20,21,-9,-45,-53,FLAT
23,28,7,35,80,55,60,45,-76,-50,-5,23,-42,-50,-30,-53,-20,-25,0,-19,-53,-23,-13,3,FLAT
2,17,2,19,44,25,26,22,25,-14,11,2,15,11,17,27,23,5,12,17,20,14,17,25,FLAT
17,30,0,30,67,19,44,25,-49,-40,-3,17,-47,-34,-45,-32,-22,-48,-34,-30,-32,-23,-28,-5,FLAT
-21,6,27,33,30,67,19,44,17,6,3,-21,-32,-34,0,-4,-30,-28,-42,-53,-5,-42,-31,-51,FLAT
26,28,3,31,33,30,67,19,-21,2,4,26,-4,8,7,5,-53,-32,4,22,-51,-26,-38,-27,FLAT
-36,6,37,43,31,33,30,67,26,-2,-14,-36,5,0,-10,-10,22,6,-7,-31,-27,-34,-10,-14,FLAT
-5,20,6,26,43,31,33,30,-36,-36,-19,-5,-10,-38,-33,-41,-31,-36,-29,-15,-14,-30,-26,-36,FLAT
42,47,5,52,26,43,31,33,-5,41,15,42,-41,5,-4,37,-15,3,-18,1,-36,5,-14,27,FLAT
14,23,22,45,52,26,43,31,42,31,38,14,37,72,53,56,1,36,34,51,27,34,20,15,FLAT
-8,10,27,37,49,71,45,52,-21,-12,0,-8,-78,-59,-25,-29,-64,-81,-73,-86,-22,-50,-35,-72,FLAT
10,47,6,53,37,49,71,45,-8,-11,-27,10,-29,-23,-27,2,-86,-70,-52,-19,-72,-92,-100,-76,FLAT
-30,75,74,149,53,37,49,71,10,38,-58,-30,2,27,-85,-20,-19,15,-85,-28,-76,-32,-110,-49,FLAT
-29,37,35,72,149,53,37,49,-30,-68,9,-29,-20,-30,-49,-59,-28,-41,-76,-49,-49,-53,-76,-57,FLAT
65,84,49,133,72,149,53,37,-29,79,18,65,-59,11,27,36,-49,49,-31,6,-57,38,-58,16,FLAT
-44,3,45,48,133,72,149,53,65,-48,37,-44,36,31,55,21,6,-37,64,-8,16,1,6,-38,FLAT
44,91,26,117,48,133,72,149,-44,25,-44,44,21,-23,-7,0,-8,56,11,65,-38,-12,20,36,FLAT
-50,8,66,74,117,48,133,72,44,-10,33,-50,0,15,-11,-6,65,-33,26,-50,36,46,44,15,FLAT
36,64,25,89,74,117,48,133,-50,-5,-20,36,-6,-15,13,-14,-50,10,-31,30,15,-38,6,-14,FLAT
30,48,17,65,89,74,117,48,36,22,46,30,-14,17,26,66,30,7,59,16,-14,32,15,60,FLAT
-5,54,10,64,65,89,74,117,30,-12,-11,-5,66,10,35,25,16,5,15,61,60,-5,48,11,FLAT
-23,19,28,47,64,65,89,74,-5,-5,12,-23,25,-17,1,-28,61,5,47,2,11,0,27,38,FLAT
39,53,20,73,47,64,65,89,-23,31,5,39,-28,26,17,16,2,14,6,11,38,36,52,41,FLAT
-49,11,63,74,73,47,64,65,39,-6,-7,-49,16,25,-2,-10,11,20,10,-33,41,8,-1,-38,FLAT
-28,8,40,48,74,73,47,64,-49,-51,-25,-28,-10,-57,-32,-77,-33,-26,-27,-38,-38,-31,-15,-61,FLAT
-18,8,34,42,48,74,73,47,-28,-24,-18,-18,-77,-75,-43,-46,-38,-81,-50,-95,-61,-50,-45,-56,FLAT
22,31,1,32,42,48,74,73,-18,-11,-1,22,-46,-35,-19,4,-95,-86,-44,-24,-56,-92,-51,-73,FLAT
31,33,19,52,32,42,48,74,22,49,29,31,4,38,28,53,-24,14,10,35,-73,-37,-15,7,FLAT
18,23,2,25,52,32,42,48,31,1,28,18,53,50,57,49,35,39,56,71,7,15,38,53,FLAT
-71,0,73,73,25,52,32,42,18,0,-48,-71,49,1,-20,-53,71,50,9,-22,53,39,8,0,FLAT
-24,3,29,32,73,25,52,32,-71,-68,-27,-24,-53,-68,-75,-95,-22,-67,-47,-77,0,-18,-18,-46,FLAT
44,46,43,89,32,73,25,52,-24,58,1,44,-95,-10,-26,20,-77,-10,-74,-51,-46,-9,-46,-33,FLAT
1,11,20,31,89,32,73,25,44,-22,36,1,20,36,37,45,-51,-32,10,21,-33,-32,-38,-50,FLAT
-55,0,56,56,31,89,32,73,1,-19,-44,-55,45,-41,-8,-54,21,17,-7,-10,-50,-51,-34,-34,FLAT
-71,21,71,92,56,31,89,32,-55,-56,-92,-71,-54,-75,-136,-126,-10,-97,-100,-125,-34,-39,-99,-81,FLAT
17,44,13,57,92,56,31,89,-71,-41,-6,17,-126,-97,-98,-54,-125,-116,-142,-109,-81,-138,-106,-108,FLAT
48,59,14,73,71,57,92,56,9,11,9,48,26,58,42,57,-45,17,36,74,-100,-39,-56,3,FLAT
-9,21,29,50,73,71,57,92,48,6,29,-9,57,17,38,39,74,64,71,48,3,23,65,65,FLAT
-30,11,107,118,50,73,71,57,-9,48,-20,-30,39,54,9,-39,48,65,18,9,65,112,51,18,FLAT
354,354,65,419,118,50,73,71,-30,312,11,354,-39,360,-9,324,9,366,20,315,18,377,29,363,FLAT
17,64,30,94,419,118,50,73,354,-18,307,17,324,294,318,371,315,342,298,341,363,348,327,332,FLAT
7,71,14,85,94,419,118,50,17,-9,0,7,371,-27,307,24,341,285,318,378,332,333,298,348,FLAT
-77,54,98,152,85,94,419,118,7,7,-60,-77,24,-2,-60,-70,378,-20,247,-53,348,292,258,301,FLAT
9,43,24,67,152,85,94,419,-77,-65,20,9,-70,-58,-40,-68,-53,-67,-40,-61,301,-85,267,-44,FLAT
9,30,22,52,67,152,85,94,9,7,22,9,-68,-58,42,18,-61,-51,-18,-59,-44,-60,-18,-52,FLAT
-24,70,40,110,52,67,152,85,9,-6,-64,-24,18,1,-42,-15,-59,-64,-22,-6,-52,-57,-82,-83,FLAT
106,109,0,109,110,52,67,152,-24,66,67,106,-15,60,3,82,-6,67,25,91,-83,2,45,100,FLAT
-8,17,8,25,109,110,52,67,106,0,84,-8,82,66,151,98,91,60,87,74,100,67,109,83,FLAT
-69,6,81,87,25,109,110,52,-8,4,-58,-69,98,4,26,-77,74,70,93,29,83,64,29,5,FLAT
-24,8,34,42,87,25,109,110,-69,-71,-26,-24,-77,-67,-84,-93,29,-67,0,-101,5,-1,67,5,FLAT
8,15,11,26,42,87,25,109,-24,-15,1,8,-93,-86,-25,-16,-101,-82,-83,-85,5,-82,1,-93,FLAT
-14,11,31,42,26,42,87,25,8,6,-10,-14,-16,-9,-9,-6,-85,-80,-35,-30,-93,-76,-93,-99,FLAT
-17,4,57,61,42,26,42,87,-14,9,-10,-17,-6,15,-20,-31,-30,0,-19,-23,-99,-71,-45,-47,FLAT
25,35,9,44,61,42,26,42,-17,-23,-6,25,-31,-14,-16,8,-23,-8,-26,-6,-47,-23,-25,2,FLAT
21,21,1,22,44,61,42,26,25,13,35,21,8,-10,29,46,-6,-1,19,29,2,5,9,15,FLAT
4,6,7,13,37,20,24,27,-26,-15,9,4,-30,-23,-16,-22,-30,-28,-17,-26,-20,-25,-11,-26,FLAT
35,43,17,60,13,37,20,24,4,45,-2,35,-22,30,7,39,-26,22,-18,13,-26,17,-19,9,FLAT
3,25,12,37,60,13,37,20,35,-2,21,3,39,43,19,38,13,28,28,42,9,20,3,16,FLAT
39,52,5,57,37,60,13,37,3,32,12,39,38,30,33,42,42,75,31,77,16,60,40,81,FLAT
-1,24,5,29,57,37,60,13,39,-1,27,-1,42,31,39,38,77,29,60,41,81,74,58,76,FLAT
68,69,12,81,29,57,37,60,-1,75,23,68,38,74,50,67,41,106,62,106,76,104,83,109,FLAT
-51,4,55,59,81,29,57,37,68,-8,14,-51,67,67,37,17,106,66,64,16,109,98,76,55,FLAT
-6,3,46,49,59,81,29,57,-51,-15,-5,-6,17,-23,9,-57,16,52,32,11,55,51,59,10,FLAT
3,22,40,62,49,59,81,29,-6,-3,-16,3,-57,-18,-21,-3,11,-26,-7,-54,10,49,16,14,FLAT
15,51,16,67,62,49,59,81,3,-9,-14,15,-3,-12,-30,18,-54,-27,-35,12,14,-35,-21,-39,FLAT
7,42,39,81,67,62,49,59,15,30,16,7,18,21,2,22,12,18,-14,25,-39,3,-19,19,FLAT
23,27,35,62,81,67,62,49,7,19,38,23,22,49,54,30,25,40,40,45,19,37,24,48,FLAT
11,57,26,83,66,62,81,67,-54,-17,-34,11,-31,-52,-73,-43,-24,-33,-35,-20,-9,-3,-19,-13,FLAT
-25,28,63,91,164,83,66,62,-126,-100,-27,-25,-115,-114,-122,-151,-169,-131,-156,-140,-146,-166,-195,-194,FLAT
46,73,4,77,91,164,83,66,-25,-13,1,46,-151,-113,-26,21,-140,-127,-121,-105,-194,-144,-155,-94,FLAT
-97,20,101,121,77,91,164,83,46,0,-44,-97,21,-13,-43,-51,-105,-113,-70,-76,-94,-127,-165,-202,FLAT
-34,65,44,109,121,77,91,164,-97,-91,-79,-34,-51,-91,-123,-131,-76,-104,-122,-85,-202,-204,-149,-110,FLAT
-3,27,24,51,109,121,77,91,-34,-23,35,-3,-131,-114,-44,-37,-85,-114,-88,-134,-110,-127,-87,-88,FLAT
-20,24,42,66,51,109,121,77,-3,-2,-17,-20,-37,-25,18,-23,-134,-116,-61,-57,-88,-116,-105,-154,FLAT
-32,5,52,57,66,51,109,121,-20,-22,-13,-32,-23,-24,-30,-52,-57,-47,5,-55,-154,-138,-74,-89,FLAT
-12,14,26,40,57,66,51,109,-32,-38,-21,-12,-52,-60,-34,-44,-55,-62,-51,-64,-89,-85,-16,-67,FLAT
6,39,26,65,40,57,66,51,-12,6,-19,6,-44,-32,-40,-6,-64,-54,-53,-38,-67,-56,-70,-58,FLAT
-32,27,43,70,65,40,57,66,6,-15,-20,-32,-6,-9,-39,-26,-38,-47,-60,-38,-58,-69,-73,-70,FLAT
-25,60,32,92,70,65,40,57,-32,-36,-58,-25,-26,-51,-78,-57,-38,-45,-97,-51,-70,-83,-118,-63,FLAT
-40,32,50,82,92,70,65,40,-25,-22,-12,-40,-57,-58,-70,-65,-51,-73,-90,-97,-63,-67,-109,-91,FLAT
84,89,7,96,82,92,70,65,-40,41,27,84,-65,19,15,44,-97,-17,-43,19,-91,-32,-63,-13,FLAT
38,41,19,60,96,82,92,70,84,50,86,38,44,91,113,122,19,69,101,82,-13,33,43,57,FLAT
-90,6,115,121,60,96,82,92,38,6,-55,-90,122,56,31,-52,82,97,58,32,57,75,46,-8,FLAT
25,40,25,65,121,60,96,82,-90,-65,-9,25,-52,-59,-64,-65,32,-9,22,-27,-8,32,49,57,FLAT
-12,7,56,63,65,121,60,96,25,19,21,-12,-65,-46,12,13,-27,-40,-43,-77,57,10,43,-39,FLAT
-133,6,137,143,63,65,121,60,-12,-52,-132,-133,13,-33,-111,-145,-77,-98,-120,-120,-39,-92,-175,-210,FLAT
15,17,55,72,143,63,65,121,-133,-67,4,15,-145,-119,-128,-118,-120,-100,-107,-130,-210,-165,-116,-105,FLAT
-39,17,63,80,72,143,63,65,15,-31,-39,-39,-118,-98,-35,-24,-130,-150,-167,-157,-105,-131,-146,-169,FLAT
-19,44,24,68,80,72,143,63,-39,-58,-46,-19,-24,-89,-85,-58,-157,-156,-81,-43,-169,-208,-213,-176,FLAT
-19,37,45,82,68,80,72,143,-19,2,-12,-19,-58,-56,-58,-38,-43,-87,-97,-77,-176,-154,-93,-62,FLAT
-6,24,21,45,106,82,68,80,91,10,71,-6,72,61,98,85,53,63,86,66,14,5,40,47,FLAT
-46,21,81,102,45,106,82,68,-6,14,-43,-46,85,24,28,-52,66,75,55,39,47,77,43,20,FLAT
-20,33,37,70,102,45,106,82,-46,-64,-32,-20,-52,-50,-75,-66,39,-40,-4,-72,20,11,23,19,FLAT
-23,15,68,83,115,70,102,45,76,22,54,-23,56,84,71,53,10,20,39,33,4,34,-4,-13,FLAT
-27,15,65,80,83,115,70,102,-23,-30,-27,-27,53,-8,27,-50,33,54,44,26,-13,-10,12,6,FLAT
157,166,4,170,80,83,115,70,-27,96,6,157,-50,66,-21,130,26,88,33,107,6,150,50,183,FLAT
-55,3,68,71,170,80,83,115,157,9,108,-55,130,105,114,102,107,75,87,75,183,97,141,52,FLAT
68,79,0,79,71,170,80,83,-55,0,-8,68,102,9,100,13,75,105,106,170,52,75,79,143,FLAT
-11,13,23,36,79,71,170,80,68,12,55,-11,13,12,47,57,170,21,155,2,143,117,161,159,FLAT
34,35,24,59,36,79,71,170,-11,35,12,34,57,47,67,23,2,47,59,91,159,56,167,36,FLAT
-9,6,42,48,59,36,79,71,34,9,20,-9,23,44,32,25,91,56,87,14,36,56,79,82,FLAT
-18,4,27,31,45,48,59,36,-41,-35,-21,-18,-50,-74,-57,-59,-16,-65,-37,-68,-27,-30,-25,-34,FLAT
7,8,13,21,31,45,48,59,-18,-7,3,7,-59,-42,-18,-11,-68,-81,-54,-52,-34,-72,-34,-61,FLAT
-15,47,17,64,21,31,45,48,7,-11,-54,-15,-11,-18,-51,-8,-52,-53,-72,-26,-61,-92,-108,-67,FLAT
-15,27,26,53,64,21,31,45,-15,-6,5,-15,-8,-17,-49,-30,-26,-24,-46,-23,-67,-59,-67,-41,FLAT
-1,7,16,23,53,64,21,31,-15,-11,19,-1,-30,-17,24,-16,-23,-28,-30,-31,-41,-35,-27,-24,FLAT
7,15,11,26,23,53,64,21,-1,2,-1,7,-16,-9,18,6,-31,-15,23,-9,-24,-26,-31,-24,FLAT
9,19,9,28,31,28,40,23,10,2,5,9,20,16,16,19,-9,4,16,29,-18,-6,-11,0,FLAT
21,28,0,28,28,31,28,40,9,12,12,21,19,14,17,30,29,28,28,40,0,16,28,50,FLAT
-10,0,16,16,28,28,31,28,21,6,18,-10,30,18,30,11,40,20,35,20,50,34,46,30,FLAT
-17,9,18,27,27,16,28,28,-20,-19,-19,-17,-30,-35,-46,-37,-9,-29,-28,-47,0,-17,-16,-26,FLAT
-44,17,44,61,27,27,16,28,-17,-18,-52,-44,-37,-37,-71,-61,-47,-53,-98,-81,-26,-47,-80,-91,FLAT
-9,17,14,31,61,27,27,16,-44,-39,-9,-9,-61,-57,-61,-53,-81,-76,-80,-70,-91,-92,-107,-90,FLAT
33,33,3,36,31,61,27,27,-9,22,17,33,-53,-17,8,24,-70,-35,-44,-20,-90,-54,-63,-37,FLAT
-33,9,34,43,36,31,61,27,33,-2,-9,-33,24,20,8,0,-20,-19,-1,-9,-37,-37,-53,-53,FLAT
-54,33,60,93,59,43,36,31,-16,-19,-53,-54,-49,-44,-94,-70,-16,-46,-103,-103,-25,-24,-86,-70,FLAT
-40,13,50,63,93,59,43,36,-54,-50,-20,-40,-70,-69,-73,-94,-103,-94,-114,-110,-70,-96,-123,-143,FLAT
24,35,10,45,63,93,59,43,-40,-16,2,24,-94,-66,-18,-16,-110,-85,-71,-70,-143,-110,-112,-86,FLAT
-68,13,122,135,45,63,93,59,24,44,-46,-68,-16,28,-44,-44,-70,-22,-64,-84,-86,-41,-117,-138,FLAT
4,19,22,41,77,70,135,45,75,26,62,4,142,98,127,79,74,46,140,146,98,90,94,78,FLAT
40,90,9,99,41,77,70,135,4,27,-31,40,79,53,31,44,146,125,96,119,78,73,109,186,FLAT
-22,11,28,39,99,41,77,70,40,-3,57,-22,44,24,26,18,119,50,88,22,186,122,153,97,FLAT
2,21,8,29,39,99,41,77,-22,-18,-8,2,18,-21,49,-20,22,6,18,20,97,32,80,24,FLAT
68,83,3,86,29,39,99,41,2,63,6,68,-20,45,-2,70,20,42,55,48,24,69,24,88,FLAT
18,49,25,74,86,29,39,99,68,40,52,18,70,103,58,86,48,85,50,88,88,82,107,66,FLAT
-4,15,34,49,74,86,29,39,18,5,30,-4,86,45,82,14,88,108,88,82,66,90,80,84,FLAT
12,38,20,58,49,74,86,29,-4,-2,-11,12,14,3,19,8,82,43,71,26,84,106,77,94,FLAT
6,33,11,44,58,49,74,86,12,-3,11,6,8,-5,0,18,26,0,30,14,94,40,82,32,FLAT
49,49,34,83,44,58,49,74,6,72,33,49,18,69,44,55,14,67,33,67,32,72,63,63,FLAT
64,84,15,99,83,44,58,49,49,45,29,64,55,117,62,113,67,114,73,119,63,112,62,131,FLAT
51,79,0,79,99,83,44,58,64,36,56,51,113,81,85,115,119,153,118,164,131,150,129,170,FLAT
22,40,38,78,79,99,83,44,51,60,61,22,115,96,117,73,164,141,146,137,170,213,179,186,FLAT
27,46,35,81,78,79,99,83,22,24,21,27,73,84,82,49,137,120,138,100,186,165,167,164,FLAT
10,40,19,59,81,78,79,99,27,-6,16,10,49,18,37,37,100,78,98,59,164,114,154,110,FLAT
0,28,45,73,59,81,78,79,10,26,12,0,37,20,28,10,59,44,49,37,110,104,110,59,FLAT
6,26,21,47,48,73,59,81,-31,-7,-6,6,-31,-49,-23,-25,-21,-23,-11,-25,6,-29,5,-15,FLAT
-76,11,88,99,47,48,73,59,6,-9,-61,-76,-25,-16,-67,-70,-25,-58,-84,-101,-15,-32,-72,-101,FLAT
-10,22,47,69,99,47,48,73,-76,-51,-21,-10,-70,-60,-82,-86,-101,-67,-88,-80,-101,-109,-105,-111,FLAT
57,77,0,77,117,69,99,47,86,37,77,57,76,96,88,143,0,45,67,133,6,36,6,57,FLAT
-49,0,60,60,77,117,69,99,57,11,28,-49,143,48,105,8,133,107,116,94,57,56,95,84,FLAT
109,128,2,130,60,77,117,69,-49,51,-19,109,8,62,9,60,94,99,86,117,84,158,97,203,FLAT
93,105,16,121,130,60,77,117,109,107,116,93,60,158,97,202,117,169,125,153,203,206,202,210,FLAT
-56,7,88,95,124,168,121,130,-86,-71,-42,-56,-218,-212,-139,-142,-125,-202,-176,-274,-16,-95,-60,-181,FLAT
-18,49,43,92,95,124,168,121,-56,-63,-60,-18,-142,-134,-102,-74,-274,-275,-199,-160,-181,-265,-236,-292,FLAT
-47,14,53,67,92,95,124,168,-18,-37,-12,-47,-74,-100,-72,-65,-160,-171,-114,-121,-292,-312,-211,-207,FLAT
21,26,27,53,67,92,95,124,-47,-5,9,21,-65,-42,-3,-26,-121,-105,-63,-44,-207,-176,-105,-100,FLAT
-12,4,65,69,53,67,92,95,21,26,10,-12,-26,21,19,9,-44,-16,7,-38,-100,-79,-53,-56,FLAT
-30,58,30,88,69,53,67,92,-12,-65,-84,-30,9,-39,-74,-42,-38,-44,-65,-21,-56,-81,-77,-68,FLAT
7,8,51,59,88,69,53,67,-30,28,57,7,-42,-37,-27,-23,-21,-11,-17,-35,-68,-16,-8,-14,FLAT
8,17,34,51,59,88,69,53,7,-9,-1,8,-23,19,56,15,-35,-46,-28,-15,-14,-20,-18,-27,FLAT
-65,5,86,91,51,59,88,69,8,-13,-53,-65,15,-22,-54,-57,-15,6,3,-50,-27,-59,-81,-80,FLAT
-28,5,60,65,91,51,59,88,-65,-54,-28,-28,-57,-67,-81,-93,-50,-76,-82,-85,-80,-48,-25,-78,FLAT
0,20,17,37,65,91,51,59,-28,-43,-15,0,-93,-97,-43,-28,-85,-110,-96,-93,-78,-119,-97,-85,FLAT
1,5,17,22,37,65,91,51,0,1,16,1,-28,-42,1,1,-93,-96,-27,-27,-85,-109,-80,-92,FLAT
16,40,3,43,22,37,65,91,1,2,-19,16,1,3,-3,17,-27,-40,-18,17,-92,-94,-46,-11,FLAT
39,43,8,51,43,22,37,65,16,44,36,39,17,46,17,55,17,47,33,56,-11,4,18,56,FLAT
-21,7,23,30,21,24,37,22,2,-3,-12,-21,10,1,-5,-19,35,9,16,-11,30,18,10,14,FLAT
-9,19,24,43,30,21,24,37,-21,-8,-21,-9,-19,-11,-33,-30,-11,-7,-26,-28,14,1,-5,-20,FLAT
28,29,2,31,43,30,21,24,-9,6,18,28,-30,-2,-3,19,-28,-5,-15,-2,-20,-1,-8,0,FLAT
-20,1,21,22,31,43,30,21,28,-1,8,-20,19,5,26,8,-2,-3,5,-1,0,-6,-7,-22,FLAT
33,38,21,59,22,31,43,30,-20,33,-4,33,8,32,4,13,-1,38,22,41,-22,30,1,32,FLAT
11,20,21,41,59,22,31,43,33,11,29,11,13,44,25,44,41,43,33,24,32,49,51,52,FLAT
35,38,4,42,41,59,22,31,11,18,17,35,44,29,46,46,24,62,42,79,52,61,50,59,FLAT
-15,5,29,34,42,41,59,22,35,10,18,-15,46,28,35,20,79,39,64,31,59,72,60,64,FLAT
-42,12,42,54,34,42,41,59,-15,-29,-49,-42,20,-19,-31,-57,31,-1,-14,-22,64,10,15,-11,FLAT
-4,9,32,41,54,34,42,41,-42,-14,-1,-4,-57,-43,-50,-46,-22,-33,-32,-61,-11,-15,-15,-26,FLAT
-18,5,25,30,41,54,34,42,-4,-25,-14,-18,-46,-39,-15,-22,-61,-68,-64,-64,-26,-58,-46,-79,FLAT
73,75,23,98,30,41,54,34,-18,71,3,73,-22,46,-11,55,-64,32,-12,51,-79,3,-61,9,FLAT
-42,16,79,95,98,30,41,54,73,14,17,-42,55,85,20,31,51,60,6,13,9,46,5,9,FLAT
-29,29,40,69,95,98,30,41,-42,-68,-42,-29,31,-54,-25,-71,13,17,-22,2,9,-8,-36,-16,FLAT
-65,9,87,96,69,95,98,30,-29,-18,-45,-65,-71,-86,-87,-94,2,-72,-70,-136,-16,-1,-67,-63,FLAT
23,57,14,71,80,62,96,69,75,36,45,23,113,92,83,98,48,63,88,136,19,45,43,71,FLAT
30,54,8,62,71,80,62,96,23,24,33,30,98,60,78,53,136,116,116,128,71,87,121,166,FLAT
5,39,30,69,62,71,80,62,30,27,20,5,53,51,53,35,128,87,98,58,166,143,136,133,FLAT
76,79,34,113,69,62,71,80,5,80,36,76,35,107,56,81,58,131,89,111,133,167,134,134,FLAT
-40,17,113,130,113,69,62,71,76,39,22,-40,81,119,58,36,111,146,78,41,134,170,111,71,FLAT
64,69,36,105,130,113,69,62,-40,-13,12,64,36,26,34,24,41,106,70,100,71,133,90,105,FLAT
-18,38,18,56,105,130,113,69,64,-36,13,-18,24,-49,25,46,100,-10,47,6,105,70,83,82,FLAT
17,31,27,58,56,105,130,113,-18,26,24,17,46,-10,37,-1,6,-23,49,63,82,16,71,23,FLAT
22,24,21,45,58,56,105,130,17,16,29,22,-1,42,53,39,63,6,66,21,23,-7,78,85,FLAT
-39,2,39,41,45,58,56,105,22,-21,-17,-39,39,-5,12,-17,21,21,36,0,85,-15,49,-18,FLAT
6,15,53,68,41,45,58,56,-39,20,-7,6,-17,-1,-24,-33,0,15,5,-11,-18,41,29,6,FLAT
21,21,28,49,68,41,45,58,6,-4,15,21,-33,16,8,27,-11,-5,-9,-12,6,11,20,10,FLAT
-5,54,17,71,49,68,41,45,21,-16,-38,-5,27,-20,-23,16,-12,0,-30,22,10,-21,-47,-17,FLAT
67,73,7,80,71,49,68,41,-5,57,48,67,16,41,10,62,22,37,25,83,-17,57,18,89,FLAT
-11,47,17,64,80,71,49,68,67,-1,15,-11,62,56,63,56,83,40,25,51,89,36,40,72,FLAT
7,17,39,56,64,80,71,49,-11,29,37,7,56,28,52,-4,51,85,100,63,72,69,62,58,FLAT
10,32,35,67,56,64,80,71,7,6,-5,10,-4,35,32,17,63,34,47,6,58,91,95,73,FLAT
16,41,44,85,67,56,64,80,10,25,7,16,17,31,2,26,6,60,39,33,73,59,54,22,FLAT
127,127,81,208,85,67,56,64,16,164,41,127,26,189,48,143,33,195,43,153,22,224,80,160,FLAT
-41,56,51,107,208,85,67,56,127,-71,30,-41,143,93,71,86,153,118,78,102,160,124,73,112,FLAT
32,82,21,103,107,208,85,67,-41,2,6,32,86,-69,36,-9,102,95,77,118,112,120,84,134,FLAT
18,37,49,86,103,107,208,85,32,46,63,18,-9,48,69,50,118,-23,99,9,134,141,140,136,FLAT
88,107,34,141,86,103,107,208,18,73,18,88,50,119,81,106,9,121,87,138,136,50,117,97,FLAT
48,69,38,107,141,86,103,107,88,52,86,48,106,125,104,136,138,171,167,154,97,173,173,186,FLAT
13,21,55,76,107,141,86,103,48,30,61,13,136,82,147,61,154,155,165,149,186,201,228,167,FLAT
74,125,5,130,76,107,141,86,13,24,-30,74,61,54,31,87,149,106,117,135,167,179,135,223,FLAT
-39,22,58,80,130,76,107,141,74,14,64,-39,87,38,34,35,135,68,95,48,223,120,181,96,FLAT
-10,26,56,82,80,130,76,107,-39,-12,-14,-10,35,2,50,-49,48,26,20,25,96,56,81,38,FLAT
59,80,6,86,82,80,130,76,-10,9,5,59,-49,-3,-9,49,25,11,55,10,38,35,25,84,FLAT
28,52,4,56,86,82,80,130,59,26,56,28,49,35,61,87,10,23,47,77,84,37,111,38,FLAT
-24,4,78,82,56,86,82,80,28,50,24,-24,87,76,80,4,77,85,85,63,38,73,71,53,FLAT
32,32,34,66,82,56,86,82,-24,-12,4,32,4,38,28,8,63,64,84,36,53,73,89,95,FLAT
6,22,40,62,66,82,56,86,32,12,16,6,8,0,20,38,36,50,44,14,95,76,100,42,FLAT
69,83,8,91,62,66,82,56,6,37,8,69,38,49,24,75,14,37,28,107,42,87,52,83,FLAT
3,19,20,39,63,37,35,91,-33,-22,2,3,-38,-24,-26,-30,-49,-27,-31,-35,20,-34,18,-46,FLAT
-4,14,23,37,39,63,37,35,3,-1,1,-4,-30,-23,3,-1,-35,-25,-25,-34,-46,-28,-30,-39,FLAT
-31,3,38,41,37,39,63,37,-4,-16,-20,-31,-1,-17,-19,-35,-34,-39,-17,-32,-39,-41,-45,-65,FLAT
-11,6,19,25,17,18,29,22,-9,-4,-12,-11,-3,-2,-9,-20,21,3,7,-14,18,20,17,10,FLAT
-6,12,14,26,25,17,18,29,-11,-11,-12,-6,-20,-15,-24,-17,-14,-13,-21,-26,10,-8,-5,-20,FLAT
-9,17,9,26,26,25,17,18,-6,-14,-14,-9,-17,-25,-26,-15,-26,-29,-38,-26,-20,-27,-35,-35,FLAT
0,9,6,15,26,26,25,17,-9,-3,8,0,-15,-17,-6,-9,-26,-28,-18,-15,-35,-32,-30,-26,FLAT
-9,2,18,20,15,26,26,25,0,3,-2,-9,-9,0,6,-9,-15,-14,-8,-18,-26,-25,-20,-24,FLAT
35,37,9,46,20,15,26,26,-9,26,0,35,-9,29,-2,26,-18,26,6,26,-24,12,-8,17,FLAT
-15,11,16,27,46,20,15,26,35,-8,11,-15,26,18,11,20,26,21,9,11,17,18,17,11,FLAT
46,50,3,53,27,46,20,15,-15,33,7,46,20,25,18,31,11,51,18,66,11,54,16,57,FLAT
-41,7,61,68,53,27,46,20,46,17,2,-41,31,50,9,5,66,42,20,-10,57,68,20,25,FLAT
-36,18,76,94,68,53,27,46,-41,-21,-47,-36,5,-4,-45,-77,-10,29,-38,-31,25,21,-27,-46,FLAT
24,38,22,60,94,68,53,27,-36,-30,4,24,-77,-51,-43,-12,-31,-34,-41,-53,-46,-1,-34,-7,FLAT
23,31,35,66,60,94,68,53,24,36,30,23,-12,6,34,47,-53,-15,-13,11,-7,2,-11,-30,FLAT
-3,24,20,44,66,60,94,68,23,-18,4,-3,47,18,34,20,11,-12,38,44,-30,-33,-9,8,FLAT
-56,11,66,77,44,66,60,94,-3,-10,-43,-56,20,-28,-39,-59,44,8,-9,-36,8,-22,-5,-12,FLAT
-2,43,9,52,77,44,66,60,-56,-59,-34,-2,-59,-69,-77,-58,-36,-87,-73,-61,-12,-51,-43,-38,FLAT
-33,17,50,67,52,77,44,66,-2,8,-7,-33,-58,-51,-41,-35,-61,-61,-84,-91,-38,-79,-80,-94,FLAT
58,79,23,102,67,52,77,44,-33,31,-4,58,-35,39,-11,25,-91,-20,-45,23,-94,-30,-88,-33,FLAT
-91,40,97,137,102,67,52,77,58,-17,-52,-91,25,14,-56,-33,23,22,-63,-66,-33,-37,-97,-68,FLAT
-19,25,21,46,137,102,67,52,-91,-95,-4,-19,-33,-112,-56,-110,-66,-81,-60,-52,-68,-73,-67,-85,FLAT
-4,35,25,60,46,137,102,67,-19,0,-14,-4,-110,-95,-18,-23,-52,-112,-70,-114,-85,-81,-74,-56,FLAT
-7,40,28,68,60,46,137,102,-4,-4,-12,-7,-23,-4,-26,-11,-114,-99,-30,-30,-56,-116,-82,-121,FLAT
-3,18,54,72,68,60,46,137,-7,23,19,-3,-11,19,7,-10,-30,19,-7,-14,-121,-76,-11,-33,FLAT
1,21,19,40,72,68,60,46,-3,-34,-2,1,-10,-11,17,-2,-14,-15,5,-9,-33,-15,-9,-13,FLAT
-9,2,31,33,40,72,68,60,1,3,10,-9,-2,-31,8,-8,-9,-8,27,-11,-13,-12,15,-18,FLAT
-36,5,54,59,33,40,72,68,-9,-13,-39,-36,-8,-10,-29,-45,-11,-44,-31,-44,-18,-21,-12,-47,FLAT
3,26,24,50,59,33,40,72,-36,-27,-18,3,-45,-40,-57,-33,-44,-37,-47,-42,-47,-71,-49,-41,FLAT
-8,32,13,45,35,50,59,33,21,-4,-14,-8,24,2,7,13,-12,-25,-11,16,-21,-38,-50,-20,FLAT
55,65,8,73,40,45,35,50,10,47,14,55,2,60,32,65,23,56,18,57,26,62,39,78,FLAT
17,37,23,60,73,40,45,35,55,32,45,17,65,79,59,72,57,92,77,82,78,88,63,74,FLAT
68,78,3,81,60,73,40,45,17,48,27,68,72,80,72,85,82,127,86,140,74,140,104,150,FLAT
-21,7,85,92,81,60,73,40,68,61,50,-21,85,109,77,47,140,141,122,64,150,188,136,119,FLAT
55,55,12,67,92,81,60,73,-21,-18,7,55,47,43,57,34,64,91,84,102,119,123,129,119,FLAT
-32,3,87,90,67,92,81,60,55,43,20,-32,34,25,27,23,102,86,77,2,119,134,104,70,FLAT
-58,34,62,96,126,90,67,92,-28,-112,-82,-58,-60,-111,-117,-86,-5,-68,-97,-118,-26,-86,-90,-63,FLAT
16,70,20,90,96,126,90,67,-58,-26,-20,16,-86,-138,-102,-42,-118,-137,-137,-70,-63,-94,-117,-102,FLAT
0,53,8,61,90,96,126,90,16,-12,17,0,-42,-38,-3,16,-70,-150,-85,-42,-102,-149,-120,-70,FLAT
33,51,35,86,61,90,96,126,0,60,35,33,16,48,52,33,-42,22,32,49,-70,-90,-50,-9,FLAT
-4,12,43,55,56,45,86,61,-13,14,15,-4,-22,-3,-13,-17,11,-18,13,-26,11,42,48,7,FLAT
-103,51,107,158,55,56,45,86,-4,-39,-142,-103,-17,-25,-127,-107,-26,-42,-155,-120,7,-57,-129,-129,FLAT
-21,26,37,63,158,55,56,45,-103,-91,4,-21,-107,-130,-138,-124,-120,-116,-123,-128,-129,-133,-151,-141,FLAT
9,41,8,49,63,158,55,56,-21,-20,-6,9,-124,-111,-2,-12,-128,-150,-144,-115,-141,-136,-129,-119,FLAT
-38,18,59,77,49,63,158,55,9,13,-15,-38,-12,-7,-21,-29,-115,-98,-17,-50,-119,-137,-159,-153,FLAT
-41,15,49,64,77,49,63,158,-38,-51,-38,-41,-29,-38,-53,-79,-50,-58,-59,-70,-153,-149,-55,-91,FLAT
-17,15,24,39,64,77,49,63,-41,-42,-17,-17,-79,-93,-55,-58,-70,-80,-70,-96,-91,-100,-76,-87,FLAT
17,26,9,35,39,64,77,49,-17,2,6,17,-58,-40,-11,0,-96,-91,-49,-41,-87,-78,-64,-79,FLAT
2,20,26,46,35,39,64,77,17,19,8,2,0,21,14,19,-41,-21,-3,2,-79,-72,-41,-39,FLAT
-33,31,38,69,46,35,39,64,2,-21,-44,-33,19,-2,-36,-31,2,0,-30,-14,-39,-42,-47,-31,FLAT
16,33,7,40,69,46,35,39,-33,-15,14,16,-31,-36,-30,-17,-14,-17,-22,-15,-31,-15,-16,2,FLAT
17,37,9,46,40,69,46,35,16,19,13,17,-17,4,27,33,-15,-17,-17,0,2,2,-9,2,FLAT
-3,7,22,29,46,40,69,46,17,10,27,-3,33,29,40,14,0,14,54,30,2,-7,10,-3,FLAT
2,36,5,41,29,46,40,69,-3,-15,-27,2,14,-5,0,-1,30,14,13,16,-3,-1,27,32,FLAT
-14,11,37,48,41,29,46,40,2,18,11,-14,-1,3,-16,-12,16,13,11,-15,32,32,24,2,FLAT
14,26,6,32,30,26,30,44,18,8,6,14,9,26,20,32,10,14,12,23,47,27,39,24,FLAT
15,33,21,54,32,30,26,30,14,30,8,15,32,38,14,29,23,56,28,47,24,44,20,38,FLAT
-5,7,9,16,54,32,30,26,15,-17,21,-5,29,13,29,10,47,21,35,24,38,39,49,42,FLAT
-16,6,21,27,16,54,32,30,-5,-4,-15,-16,10,-21,6,-21,24,9,14,-6,42,17,20,8,FLAT
6,12,10,22,27,16,54,32,-16,-5,0,6,-21,-9,-15,-10,-6,-26,6,-15,8,4,14,0,FLAT
6,6,14,20,50,22,27,16,29,4,34,6,35,39,41,35,19,34,41,41,14,30,26,25,FLAT
11,13,29,42,20,50,22,27,6,26,4,11,35,30,38,17,41,65,45,46,25,60,45,52,FLAT
36,43,17,60,42,20,50,22,11,24,6,36,17,50,10,47,46,54,44,53,52,89,51,82,FLAT
22,22,21,43,60,42,20,50,36,26,43,22,47,50,49,58,53,76,53,69,82,80,87,75,FLAT
15,17,9,26,43,60,42,20,22,3,20,15,58,29,63,37,69,53,69,73,75,79,73,84,FLAT
-34,23,37,60,26,43,60,42,15,-6,-40,-34,37,-3,-20,-19,73,23,23,3,84,47,29,39,FLAT
-3,37,15,52,60,26,43,60,-34,-25,-17,-3,-19,-31,-57,-37,3,-28,-37,-22,39,-2,6,0,FLAT
-6,29,27,56,52,60,26,43,-3,6,2,-6,-37,-19,-15,-9,-22,-25,-55,-43,0,-22,-35,-28,FLAT
32,62,2,64,97,56,52,60,48,29,62,32,42,55,47,80,39,61,49,74,5,36,32,71,FLAT
130,132,28,160,64,97,56,52,32,156,60,130,80,185,122,162,74,211,107,210,71,217,109,204,FLAT
84,102,6,108,160,64,97,56,130,62,114,84,162,218,174,214,210,247,236,246,204,273,221,294,FLAT
-10,39,26,65,108,160,64,97,84,10,53,-10,214,72,167,74,246,228,227,204,294,257,289,236,FLAT
30,39,43,82,65,108,160,64,-10,47,30,30,74,57,83,20,204,119,197,104,236,275,257,234,FLAT
-28,26,36,62,82,65,108,160,30,-35,-15,-28,20,12,15,2,104,22,68,-8,234,84,182,76,FLAT
-1,24,20,44,62,82,65,108,-28,-17,1,-1,2,-52,-14,-29,-8,-5,16,1,76,5,69,-9,FLAT
28,53,0,53,44,62,82,65,-1,8,-1,28,-29,-9,0,27,1,-44,-15,-1,-9,3,15,29,FLAT
64,81,41,122,53,44,62,82,28,105,36,64,27,113,35,92,-1,96,36,91,29,61,21,63,FLAT
-17,20,36,56,93,100,122,53,-34,-38,-1,-17,-44,-39,5,-51,20,-66,0,-61,48,39,36,3,FLAT
-38,5,67,72,56,93,100,122,-17,-7,-23,-38,-51,-45,-24,-55,-61,-46,-18,-89,3,-73,-23,-99,FLAT
-36,52,36,88,72,56,93,100,-38,-67,-83,-36,-55,-74,-106,-74,-89,-112,-107,-91,-99,-113,-101,-125,FLAT
4,21,24,45,88,72,56,93,-36,-8,35,4,-74,-75,-48,-32,-91,-82,-71,-70,-125,-120,-72,-87,FLAT
-51,17,53,70,45,88,72,56,4,-22,-47,-51,-32,-30,-12,-47,-70,-97,-95,-83,-87,-104,-118,-121,FLAT
-10,10,56,66,70,45,88,72,-51,-7,-3,-10,-47,-29,-50,-61,-83,-37,-15,-57,-121,-104,-98,-93,FLAT
-41,16,47,63,66,70,45,88,-10,-50,-47,-41,-61,-57,-50,-51,-57,-79,-97,-102,-93,-87,-62,-98,FLAT
54,58,29,87,63,66,70,45,-41,36,12,54,-51,-14,-35,13,-102,-21,-38,3,-98,-43,-85,-48,FLAT
-37,7,67,74,87,63,66,70,54,1,14,-37,13,37,26,17,3,-13,-21,-24,-48,-20,-24,-34,FLAT
-6,35,12,47,74,87,63,66,-37,-61,-34,-6,17,-60,-20,-43,-24,-24,-8,11,-34,-74,-55,-30,FLAT
21,24,26,50,47,74,87,63,-6,35,32,21,-43,-26,-2,15,11,-25,12,-22,-30,11,24,32,FLAT
20,38,11,49,50,47,74,87,21,5,6,20,15,40,38,41,-22,-21,4,35,32,-20,18,-2,FLAT
-15,8,50,58,49,50,47,74,20,24,15,-15,41,29,21,5,35,64,53,26,-2,3,19,20,FLAT
-96,44,101,145,58,49,50,47,-15,-45,-132,-96,5,-21,-117,-111,26,-16,-111,-91,20,19,-79,-70,FLAT
-40,100,45,145,145,58,49,50,-96,-96,-96,-40,-111,-141,-228,-136,-91,-117,-213,-151,-70,-112,-207,-131,FLAT
52,59,34,93,145,145,58,49,-40,41,93,52,-136,-55,-3,12,-151,-100,-135,-84,-131,-76,-120,-99,FLAT
-73,10,91,101,93,145,145,58,52,-16,-24,-73,12,25,69,-21,-84,-71,-27,-61,-99,-116,-159,-157,FLAT
35,38,21,59,101,93,145,145,-73,-35,7,35,-21,-51,-17,-38,-61,-10,76,14,-157,-106,-20,-26,FLAT
-71,22,80,102,59,101,93,145,35,-12,-55,-71,-38,-47,-48,-36,14,-63,-72,-109,-26,-22,21,-57,FLAT
79,110,10,120,102,59,101,93,-71,9,-9,79,-36,-3,-64,8,-109,-38,-57,43,-57,-54,-81,-30,FLAT
-8,36,24,60,120,102,59,101,79,6,66,-8,8,15,57,71,43,3,2,0,-30,-32,9,35,FLAT
-9,45,16,61,60,120,102,59,-8,-17,-18,-9,71,-11,48,-17,0,-2,39,62,35,-14,-16,-9,FLAT
-74,14,80,94,61,60,120,102,-9,-10,-43,-74,-17,-27,-61,-83,62,-21,5,-91,-9,-12,-4,-12,FLAT
17,27,29,56,94,61,60,120,-74,-34,4,17,-83,-44,-39,-57,-91,-61,-57,-66,-12,-55,9,-74,FLAT
-35,5,39,44,56,94,61,60,17,-25,-13,-35,-57,-59,-9,-18,-66,-69,-52,-92,-74,-86,-70,-101,FLAT
45,49,8,57,44,56,94,61,-35,14,1,45,-18,-11,-12,10,-92,-45,-8,27,-101,-55,-51,-47,FLAT
-3,18,32,50,57,44,56,94,45,21,28,-3,10,35,29,42,27,10,16,7,-47,-24,20,24,FLAT
18,40,12,52,50,57,44,56,-3,-2,-4,18,42,19,24,15,7,33,25,60,24,8,12,25,FLAT
-33,15,50,65,52,50,57,44,18,5,-8,-33,15,3,-12,-15,60,24,16,-18,25,38,17,27,FLAT
15,36,4,40,65,52,50,57,-33,-31,-6,15,-15,-26,-14,-18,-18,-28,-18,0,27,-7,10,-3,FLAT
-2,4,12,16,25,18,40,34,11,3,12,-2,11,12,14,9,49,21,45,9,66,45,63,47,FLAT
-21,0,21,21,16,25,18,40,-2,-12,-17,-21,9,-9,-5,-23,9,0,-3,-12,47,9,28,-12,FLAT
12,20,2,22,21,16,25,18,-21,-7,-8,12,-23,-19,-25,-9,-12,-16,-13,-11,-12,-7,-11,0,FLAT
44,45,1,46,22,21,16,25,12,43,19,44,-9,36,11,56,-11,24,-6,35,0,27,6,33,FLAT
-4,10,10,20,46,22,21,16,44,5,31,-4,56,48,50,40,35,41,42,52,33,29,25,31,FLAT
67,74,7,81,20,46,22,21,-4,64,3,67,40,69,34,63,52,112,53,107,31,105,45,119,FLAT
51,55,4,59,81,20,46,22,67,48,70,51,63,112,73,118,107,117,104,114,119,160,123,158,FLAT
10,30,13,43,59,81,20,46,51,19,35,10,118,67,105,61,114,131,108,128,158,136,139,124,FLAT
-122,2,122,124,43,59,81,20,10,-13,-94,-122,61,6,-59,-112,128,54,11,-61,124,118,14,6,FLAT
117,129,7,136,124,43,59,81,-122,2,-10,117,-112,-11,-104,-5,-61,8,-69,5,6,56,1,56,FLAT
-4,28,33,61,136,124,43,59,117,22,97,-4,-5,24,87,113,5,11,-7,-9,56,30,28,1,FLAT
8,19,32,51,61,136,124,43,-4,7,17,8,113,29,114,4,-9,31,104,121,1,18,10,-1,FLAT
-23,13,28,41,51,61,136,124,8,-27,-17,-23,4,-20,0,-15,121,2,97,-19,-1,4,87,98,FLAT
19,20,39,59,41,51,61,136,-23,30,12,19,-15,3,-5,-4,-19,10,12,4,98,32,109,0,FLAT
21,41,76,117,59,41,51,61,19,58,0,21,-4,88,12,40,4,61,-5,17,0,68,12,25,FLAT
37,45,74,119,117,59,41,51,21,35,33,37,40,93,33,58,17,123,45,77,25,96,28,54,FLAT
-5,32,36,68,119,117,59,41,37,-43,8,-5,58,-8,41,32,77,50,41,53,54,80,53,72,FLAT
13,71,1,72,68,119,117,59,-5,-22,-26,13,32,-65,-18,8,53,-30,15,45,72,28,15,66,FLAT
10,51,12,63,72,68,119,117,13,21,30,10,8,-1,4,23,45,-44,12,18,66,-9,45,55,FLAT
15,46,10,56,63,72,68,119,10,13,20,15,23,34,50,25,18,12,24,38,55,-31,32,33,FLAT
41,66,7,73,56,63,72,68,15,38,21,41,25,51,41,56,38,72,71,66,33,50,45,79,FLAT
-1,67,31,98,73,56,63,72,41,23,-2,-1,56,61,19,40,66,74,39,55,79,95,69,65,FLAT
39,52,42,94,58,56,98,73,-23,25,-11,39,-57,13,-25,16,-58,-7,-3,-18,-17,16,-5,-19,FLAT
-22,8,33,41,94,58,56,98,39,-31,22,-22,16,-6,11,17,-18,-18,-3,-6,-19,-38,19,-40,FLAT
-44,16,48,64,41,94,58,56,-22,-29,-52,-44,17,-60,-30,-66,-6,-35,-41,-27,-40,-47,-55,-50,FLAT
-17,24,44,68,64,41,94,58,-44,-21,-25,-17,-66,-50,-77,-61,-27,-81,-55,-83,-50,-56,-66,-44,FLAT
12,26,6,32,68,64,41,94,-17,-26,10,12,-61,-47,-15,-5,-83,-76,-67,-49,-44,-107,-45,-71,FLAT
-27,18,30,48,32,68,64,41,12,-3,-19,-27,-5,-29,-9,-15,-49,-50,-34,-32,-71,-79,-86,-76,FLAT
6,35,7,42,48,32,68,64,-27,-17,-11,6,-15,-20,-30,-21,-32,-46,-20,-9,-76,-67,-45,-26,FLAT
-18,5,32,37,42,48,32,68,6,7,12,-18,-21,-10,1,-12,-9,-13,-18,-39,-26,-39,-8,-27,FLAT
-6,22,15,37,37,42,48,32,-18,-23,-23,-6,-12,-16,-11,-24,-39,-33,-22,-18,-27,-36,-41,-45,FLAT
3,39,9,48,37,37,42,48,-6,-3,-14,3,-24,-26,-37,-3,-18,-19,-25,-21,-45,-36,-36,-15,FLAT
-2,29,24,53,48,37,37,42,3,13,8,-2,-3,10,-6,1,-21,-13,-29,-5,-15,-6,-17,-23,FLAT
201,305,93,398,53,48,37,37,-2,270,-75,201,1,283,-67,199,-5,280,-81,202,-23,257,-104,196,FLAT
21,111,29,140,173,109,398,53,-130,-118,-85,21,-132,-116,-147,-109,69,-175,83,-111,67,95,8,90,FLAT
-47,12,168,180,140,173,109,398,21,92,52,-47,-109,-26,-33,-26,-111,-24,-95,-156,90,-83,135,-158,FLAT
-46,9,56,65,180,140,173,109,-47,-158,-43,-46,-26,-66,9,-93,-156,-184,-76,-72,-158,-182,-138,-202,FLAT
-122,36,128,164,65,180,140,173,-46,-50,-149,-122,-93,-208,-192,-168,-72,-116,-140,-215,-202,-234,-225,-194,FLAT
21,41,61,102,93,165,164,65,51,82,73,21,180,105,168,72,58,134,196,201,12,84,47,79,FLAT
48,81,23,104,102,93,165,164,21,10,8,48,72,92,81,69,201,115,176,120,79,144,204,249,FLAT
-121,20,129,149,104,102,93,165,48,-15,-60,-121,69,-5,-52,-73,120,77,21,-52,249,100,116,-1,FLAT
-66,20,70,90,149,104,102,93,-121,-125,-66,-66,-73,-140,-126,-187,-52,-130,-118,-139,-1,-48,-45,-118,FLAT
8,16,21,37,71,70,90,149,44,12,46,8,77,37,70,52,11,36,89,85,-110,-89,23,19,FLAT
-6,5,47,52,37,71,70,90,8,20,5,-6,52,32,51,2,85,57,75,46,19,56,94,79,FLAT
67,74,12,86,52,37,71,70,-6,32,-2,67,2,52,3,61,46,64,49,69,79,89,73,113,FLAT
-47,7,67,74,86,52,37,71,67,8,20,-47,61,40,18,20,69,60,23,14,113,72,69,22,FLAT
-4,20,12,32,77,38,74,86,-74,-69,-24,-4,-86,-100,-94,-78,-133,-145,-103,-90,-66,-137,-83,-137,FLAT
2,14,0,14,25,12,42,23,-21,-20,-9,2,-23,-24,-26,-19,-59,-60,-32,-21,-46,-60,-51,-57,FLAT
-38,7,41,48,14,25,12,42,2,3,-31,-38,-19,-17,-40,-36,-21,-21,-57,-57,-57,-57,-63,-59,FLAT
6,22,3,25,48,14,25,12,-38,-32,-9,6,-36,-29,-40,-32,-57,-49,-49,-30,-59,-53,-66,-51,FLAT
20,20,13,33,25,48,14,25,6,30,22,20,-32,-2,13,26,-30,1,-18,-12,-51,-19,-27,-10,FLAT
8,8,23,31,33,25,48,14,20,18,20,8,26,48,42,28,-12,16,33,34,-10,19,2,-4,FLAT
-3,10,11,21,31,33,25,48,8,-15,-5,-3,28,3,15,5,34,33,37,25,-4,1,28,31,FLAT
-76,0,76,76,21,31,33,25,-3,-11,-66,-76,5,-26,-71,-79,25,-8,-51,-71,31,22,-29,-51,FLAT
37,66,0,66,76,21,31,33,-76,-39,-29,37,-79,-50,-95,-39,-71,-65,-100,-42,-51,-47,-80,-34,FLAT
-91,26,112,138,66,76,21,31,37,21,-51,-91,-39,-18,-80,-54,-42,-29,-146,-130,-34,-44,-151,-133,FLAT
7,26,14,40,52,76,138,66,43,20,32,7,93,38,74,50,2,2,100,100,39,23,49,9,FLAT
-10,11,19,30,40,52,76,138,7,-5,5,-10,50,15,37,-3,100,33,79,40,9,-3,105,90,FLAT
44,44,10,54,30,40,52,76,-10,35,11,44,-3,30,16,34,40,50,48,41,90,68,90,84,FLAT
40,84,11,95,54,30,40,52,44,41,0,40,34,76,11,84,41,71,16,74,84,91,48,81,FLAT
-19,6,50,56,95,54,30,40,40,20,59,-19,84,61,59,21,74,96,70,65,81,91,75,55,FLAT
-23,4,33,37,56,95,54,30,-19,-40,-21,-23,21,-20,38,-42,65,21,38,-2,55,56,49,42,FLAT
5,42,14,56,37,56,95,54,-23,-14,-33,5,-42,-54,-54,-18,-2,-34,5,-37,42,7,5,3,FLAT
63,73,4,77,56,37,56,95,5,53,32,63,-18,39,-1,68,-37,-1,-22,45,3,19,37,26,FLAT
31,44,4,48,77,56,37,56,63,31,60,31,68,84,92,94,45,70,59,99,26,30,38,76,FLAT
26,29,27,56,48,77,56,37,31,49,41,26,94,80,101,57,99,133,133,120,76,119,100,125,FLAT
-41,17,63,80,56,48,77,56,26,-5,-29,-41,57,44,12,-15,120,75,72,16,125,128,104,79,FLAT
57,65,8,73,80,56,48,77,-41,2,9,57,-15,-3,-20,16,16,46,21,42,79,77,81,73,FLAT
13,22,52,74,73,80,56,48,57,57,56,13,16,59,65,70,42,54,36,29,73,103,77,55,FLAT
-5,9,18,27,74,73,80,56,13,-39,8,-5,70,18,64,8,29,20,73,65,55,15,44,24,FLAT
4,27,15,42,27,74,73,80,-5,1,-14,4,8,-38,-6,-1,65,19,50,12,24,21,59,69,FLAT
22,42,18,60,42,27,74,73,4,25,7,22,-1,26,-7,26,12,-13,1,21,69,44,57,34,FLAT
-6,31,10,41,60,42,27,74,22,-14,5,-6,26,11,12,16,21,12,-2,20,34,-27,6,15,FLAT
1,4,33,37,41,60,42,27,-6,24,28,1,16,10,33,-5,20,35,40,17,15,36,26,21,FLAT
3,21,6,27,37,41,60,42,1,-24,-14,3,-5,0,14,4,17,-14,19,-2,21,11,26,20,FLAT
-13,10,23,33,27,37,41,60,3,4,-2,-13,4,-20,-16,-10,-2,4,12,-9,20,-10,17,-15,FLAT
-8,29,22,51,33,27,37,41,-13,-9,-27,-8,-10,-5,-29,-21,-9,-29,-43,-18,-15,-5,-15,-17,FLAT
-14,11,43,54,51,33,27,37,-8,7,4,-14,-21,-2,-23,-22,-18,2,-25,-35,-17,-22,-39,-32,FLAT
99,126,11,137,79,96,54,51,50,91,33,99,145,159,118,149,131,212,129,244,123,219,133,230,FLAT
33,77,24,101,137,79,96,54,99,46,82,33,149,137,115,132,244,205,200,182,230,258,211,277,FLAT
21,59,20,79,101,137,79,96,33,17,39,21,132,63,121,54,182,154,154,153,277,222,239,203,FLAT
33,42,31,73,79,101,137,79,21,44,50,33,54,61,89,54,153,107,171,87,203,198,204,186,FLAT
58,71,23,94,73,79,101,137,33,50,29,58,54,94,79,91,87,111,118,112,186,157,200,145,FLAT
26,57,2,59,94,73,79,101,58,5,40,26,91,55,69,84,112,99,119,117,145,116,158,138,FLAT
-11,24,12,36,59,94,73,79,26,-1,22,-11,84,4,62,15,117,54,91,73,138,98,141,106,FLAT
37,38,14,52,36,59,94,73,-11,39,23,37,15,38,45,26,73,43,85,52,106,93,114,110,FLAT
38,46,26,72,52,36,59,94,37,50,30,38,26,89,53,75,52,88,75,64,110,93,115,90,FLAT
47,60,4,64,72,52,36,59,38,25,33,47,75,75,63,85,64,114,86,122,90,113,108,111,FLAT
-67,9,67,76,64,72,52,36,47,-4,-16,-67,85,21,17,-20,122,71,47,18,111,110,70,55,FLAT
12,16,32,48,76,64,72,52,-67,-23,5,12,-20,-27,-11,-55,18,-2,22,-8,55,48,52,30,FLAT
64,86,5,91,48,76,64,72,12,37,-6,64,-55,14,-1,76,-8,10,-17,9,30,35,16,56,FLAT
11,40,2,42,91,48,76,64,64,8,57,11,76,45,51,75,9,22,56,87,56,18,40,20,FLAT
11,37,4,41,42,91,48,76,11,13,14,11,75,21,71,22,87,58,65,86,20,35,70,98,FLAT
30,35,4,39,41,42,91,48,11,30,32,30,22,43,46,41,86,51,103,52,98,88,97,116,FLAT
-17,15,26,41,39,41,42,91,30,5,3,-17,41,35,35,13,52,48,49,24,116,56,106,35,FLAT
20,20,18,38,41,39,41,42,-17,12,15,20,13,17,18,3,24,47,50,33,35,60,64,44,FLAT
-6,21,7,28,36,44,36,30,27,-3,5,-6,-11,-10,6,21,6,-18,-10,-17,16,-10,-8,0,FLAT
-15,19,17,36,28,36,44,36,-6,-5,-13,-15,21,-8,-8,-21,-17,-15,-7,6,0,-23,-23,-32,FLAT
5,6,20,26,36,28,36,44,-15,8,18,5,-21,3,5,-10,6,0,10,-16,-32,-7,11,11,FLAT
9,9,18,27,26,36,28,36,5,7,6,9,-10,15,24,14,-16,10,11,-1,11,7,16,-7,FLAT
-17,1,31,32,27,26,36,28,9,-4,-9,-17,14,3,-3,-8,-1,11,15,-3,-7,6,2,-18,FLAT
-39,18,39,57,32,27,26,36,-17,-31,-56,-39,-8,-35,-65,-56,-3,-28,-59,-47,-18,-20,-41,-42,FLAT
66,68,12,80,57,32,27,26,-39,39,16,66,-56,8,-40,27,-47,4,-49,10,-42,11,-43,19,FLAT
46,46,14,60,80,57,32,27,66,48,68,46,27,87,84,112,10,56,28,73,19,52,19,56,FLAT
-3,0,51,51,60,80,57,32,46,34,43,-3,112,82,111,43,73,121,127,109,56,90,71,70,FLAT
-11,33,32,65,51,60,80,57,-3,-30,-44,-11,43,4,-1,-14,109,52,67,32,70,91,83,98,FLAT
-42,2,64,66,65,51,60,80,-11,-10,-11,-42,-14,-40,-55,-53,32,-6,-12,-56,98,42,56,-10,FLAT
-40,3,45,48,66,65,51,60,-42,-59,-41,-40,-53,-69,-52,-82,-56,-99,-96,-93,-10,-65,-53,-96,FLAT
13,68,2,70,48,66,65,51,-40,-30,-52,13,-82,-89,-93,-27,-93,-99,-104,-69,-96,-129,-148,-80,FLAT
-19,30,48,78,70,48,66,65,13,27,19,-19,-27,-3,-33,-6,-69,-62,-74,-46,-80,-72,-85,-88,FLAT
94,98,18,116,74,54,78,70,45,100,58,94,90,149,87,139,71,154,116,184,84,181,135,165,FLAT
22,36,11,47,116,74,54,78,94,15,84,22,139,115,142,116,184,164,171,161,165,169,200,206,FLAT
-35,11,45,56,47,116,74,54,22,-1,-10,-35,116,14,74,-13,161,114,132,81,206,163,161,126,FLAT
88,88,12,100,56,47,116,74,-35,55,11,88,-13,54,1,53,81,69,85,75,126,169,143,169,FLAT
-18,13,47,60,100,56,47,116,88,17,57,-18,53,72,68,70,75,71,58,35,169,86,142,57,FLAT
94,110,1,111,60,100,56,47,-18,48,-3,94,70,65,54,76,35,120,65,164,57,119,55,129,FLAT
16,40,11,51,111,60,100,56,94,26,86,16,76,74,83,110,164,91,140,92,129,146,151,180,FLAT
-5,4,42,46,51,111,60,100,16,26,31,-5,110,52,117,11,92,100,114,105,180,117,171,87,FLAT
42,78,3,81,46,51,111,60,-5,3,-32,42,11,29,-1,37,105,55,85,53,87,103,82,147,FLAT
-73,9,87,96,81,46,51,111,42,11,-4,-73,37,14,-36,-31,53,40,-5,-36,147,66,81,-20,FLAT
-9,49,21,70,96,81,46,51,-73,-75,-49,-9,-31,-64,-53,-82,-36,-61,-85,-40,-20,-35,-54,-45,FLAT
21,30,35,65,70,96,81,46,-9,35,40,21,-82,-40,-9,12,-40,-29,-13,-61,-45,-26,-45,-19,FLAT
9,12,31,43,65,70,96,81,21,5,27,9,12,40,67,30,-61,-35,18,21,-19,-24,14,-52,FLAT
-85,3,85,88,34,93,43,65,-4,-13,-67,-85,-83,-94,-89,-89,-74,-114,-159,-168,-53,-109,-132,-159,FLAT
-77,1,112,113,88,34,93,43,-85,-50,-75,-77,-89,-63,-142,-162,-168,-144,-164,-166,-159,-164,-234,-245,FLAT
281,346,14,360,244,172,113,88,188,272,156,281,318,474,286,469,241,501,254,599,156,451,179,522,FLAT
-134,123,171,294,360,244,172,113,281,23,89,-134,469,295,245,147,599,497,375,335,522,524,343,465,FLAT
103,160,54,214,294,360,244,172,-134,-14,66,103,147,9,155,-31,335,281,311,250,465,483,441,438,FLAT
119,126,76,202,214,294,360,244,103,141,153,119,-31,127,219,222,250,150,308,88,438,422,464,369,FLAT
44,144,16,160,202,214,294,360,119,-16,26,44,222,125,179,163,88,111,245,266,369,134,334,132,FLAT
84,106,18,124,160,202,214,294,44,86,122,84,163,70,148,128,266,211,301,247,132,197,367,350,FLAT
53,55,73,128,124,160,202,214,84,108,104,53,128,194,226,137,247,178,252,181,350,319,405,300,FLAT
132,132,24,156,128,124,160,202,53,83,55,132,137,191,159,185,181,277,281,269,300,261,307,313,FLAT
-32,29,68,97,156,128,124,160,132,12,71,-32,185,95,126,100,269,203,230,153,313,289,352,237,FLAT
-39,29,70,99,97,156,128,124,-32,-37,-39,-39,100,-25,32,-71,153,58,87,61,237,166,191,114,FLAT
88,97,12,109,99,97,156,128,-39,30,20,88,-71,-7,-19,49,61,5,52,17,114,88,107,149,FLAT
86,110,2,112,109,99,97,156,88,76,73,86,49,106,93,174,17,69,54,135,149,81,125,103,FLAT
62,78,0,78,112,109,99,97,86,60,94,62,174,136,167,148,135,166,187,236,103,129,148,197,FLAT
-16,39,31,70,78,112,109,99,62,15,23,-16,148,75,117,46,236,151,190,132,197,181,210,220,FLAT
68,73,5,78,70,78,112,109,-16,42,34,68,46,57,57,52,132,117,151,114,220,193,224,200,FLAT
32,39,24,63,78,70,78,112,68,51,66,32,52,93,100,100,114,108,123,84,200,168,217,146,FLAT
-21,27,33,60,63,78,70,78,32,-12,-9,-21,100,39,57,11,84,81,91,79,146,96,114,63,FLAT
32,47,14,61,60,63,78,70,-21,13,12,32,11,1,3,11,79,52,69,43,63,94,103,111,FLAT
-17,25,31,56,61,60,63,78,32,0,5,-17,11,13,17,15,43,1,8,-6,111,52,74,26,FLAT
24,25,5,30,56,61,60,63,-17,-2,24,24,15,-2,29,7,-6,11,41,39,26,-1,32,18,FLAT
19,27,3,30,30,56,61,60,24,17,17,19,7,15,41,43,39,15,46,26,18,28,58,58,FLAT
-34,7,71,78,30,30,56,61,19,34,-14,-34,43,51,3,-15,26,49,27,9,58,49,32,-8,FLAT
-39,1,39,40,20,45,50,70,0,-6,-26,-39,32,-4,1,-39,56,6,16,-7,1,-6,24,17,FLAT
27,41,7,48,40,20,45,50,-39,-5,-13,27,-39,-11,-39,-12,-7,-9,-12,-12,17,1,3,20,FLAT
17,19,0,19,48,40,20,45,27,10,39,17,-12,5,26,44,-12,-1,0,5,20,1,27,5,FLAT
-10,7,17,24,19,48,40,20,17,7,2,-10,44,17,41,7,5,12,28,34,5,6,2,-5,FLAT
-27,0,38,38,24,19,48,40,-10,-6,-20,-27,7,1,-18,-37,34,11,21,-20,-5,6,8,7,FLAT
1,12,16,28,38,24,19,48,-27,-21,-11,1,-37,-27,-31,-26,-20,-20,-29,-36,7,-10,10,-19,FLAT
22,26,16,42,28,38,24,19,1,22,8,22,-26,1,-3,23,-36,-5,-23,-4,-19,2,-21,-14,FLAT
22,38,3,41,42,28,38,24,22,9,10,22,23,31,18,44,-4,10,7,45,-14,4,-13,18,FLAT
-36,3,54,57,41,42,28,38,22,15,-1,-36,44,24,9,-14,45,46,17,8,18,25,6,9,FLAT
79,83,9,92,57,41,42,28,-36,34,-1,79,-14,49,-2,43,8,58,8,65,9,80,16,87,FLAT
87,92,16,108,92,57,41,42,79,94,78,87,43,128,77,166,65,143,76,130,87,152,86,152,FLAT
-73,22,136,158,108,92,57,41,87,47,-3,-73,166,141,75,14,130,175,74,93,152,190,73,57,FLAT
-16,16,59,75,158,108,92,57,-73,-93,-10,-16,14,-46,-13,-89,93,48,65,-2,57,82,64,77,FLAT
-23,13,72,85,75,158,108,92,-16,-10,-20,-23,-89,-103,-30,-39,-2,-56,-33,-112,77,38,45,-25,FLAT
-39,73,47,120,85,75,158,108,-23,-64,-99,-39,-39,-74,-119,-62,-112,-167,-129,-78,-25,-120,-132,-151,FLAT
-10,14,67,81,120,85,75,158,-39,10,49,-10,-62,-54,-50,-49,-78,-64,-70,-72,-151,-157,-80,-88,FLAT
24,63,19,82,81,120,85,75,-10,-24,-25,24,-49,-14,24,14,-72,-78,-75,-25,-88,-88,-95,-48,FLAT
39,83,4,87,82,81,120,85,24,24,19,39,14,0,-6,63,-25,10,43,53,-48,-54,-56,14,FLAT
22,43,42,85,87,82,81,120,39,60,62,22,63,84,81,61,53,60,56,85,14,70,105,75,FLAT
-22,4,71,75,85,87,82,81,22,7,17,-22,61,67,79,0,85,91,98,39,75,67,73,63,FLAT
42,53,30,83,75,85,87,82,-22,1,-7,42,0,8,10,20,39,68,72,42,63,92,91,81,FLAT
-83,0,90,90,83,75,85,87,42,-23,-30,-83,20,-22,-37,-41,42,-15,-20,-63,81,45,42,-41,FLAT
43,71,2,73,90,83,75,85,-83,-45,-28,43,-41,-68,-58,-40,-63,-67,-65,2,-41,-60,-48,-20,FLAT
12,32,7,39,73,90,83,75,43,17,51,12,-40,-28,23,55,2,-51,-7,-28,-20,-50,-14,14,FLAT
15,42,3,45,39,73,90,83,12,11,5,15,55,28,56,27,-28,-17,28,70,14,-40,-2,-13,FLAT
-25,8,25,33,45,39,73,90,15,-3,9,-25,27,8,14,-10,70,25,65,2,-13,-20,37,45,FLAT
-25,10,31,41,33,45,39,73,-25,-19,-27,-25,-10,-22,-18,-50,2,-11,-13,-35,45,6,38,-23,FLAT
40,52,16,68,41,33,45,39,-25,25,-2,40,-50,6,-29,15,-35,3,-20,-10,-23,14,-15,5,FLAT
-40,1,51,52,68,41,33,45,40,-5,11,-40,15,20,9,0,-10,1,-18,-25,5,-2,-9,-50,FLAT
136,136,6,142,52,68,41,33,-40,91,1,136,0,86,12,96,-25,111,10,136,-50,92,-17,111,FLAT
-4,69,5,74,142,52,68,41,136,-5,63,-4,96,86,64,132,136,81,75,92,111,106,73,132,FLAT
3,22,29,51,74,142,52,68,-4,27,50,3,132,22,113,-1,92,113,114,135,132,108,125,95,FLAT
25,25,56,81,51,74,142,52,3,52,22,25,-1,79,72,28,135,74,135,24,95,165,136,160,FLAT
65,75,16,91,81,51,74,142,25,25,15,65,28,77,37,90,24,104,87,93,160,99,150,89,FLAT
-27,35,41,76,142,74,91,81,-115,-117,-51,-27,-132,-156,-158,-142,-67,-134,-119,-159,-42,-109,-104,-94,FLAT
-67,17,99,116,76,142,74,91,-27,-9,-49,-67,-142,-126,-100,-94,-159,-165,-207,-209,-94,-143,-168,-226,FLAT
90,95,29,124,116,76,142,74,-67,20,12,90,-94,11,-37,23,-209,-106,-88,-4,-226,-145,-195,-119,FLAT
11,71,40,111,124,116,76,142,90,22,35,11,23,42,47,101,-4,33,-2,34,-119,-84,-53,7,FLAT
-57,47,88,135,256,80,111,124,-115,-222,-101,-57,-125,-100,-155,-172,-114,-134,-158,-182,-24,-112,-123,-171,FLAT
-35,0,67,67,135,256,80,111,-57,-56,12,-35,-172,-278,-89,-92,-182,-156,-143,-207,-171,-190,-146,-217,FLAT
-74,76,83,159,67,135,256,80,-35,-58,-150,-74,-92,-114,-138,-109,-207,-336,-239,-166,-217,-214,-293,-281,FLAT
44,66,12,78,159,67,135,256,-74,-27,54,44,-109,-85,-96,-30,-166,-141,-84,-65,-281,-363,-185,-122,FLAT
-11,49,32,81,78,159,67,135,44,9,6,-11,-30,-18,60,33,-65,-76,-90,-41,-122,-132,-78,-76,FLAT
-48,3,73,76,81,78,159,67,-11,-7,-2,-48,33,2,4,-59,-41,-25,58,-15,-76,-83,-92,-89,FLAT
4,25,7,32,76,81,78,159,-48,-62,-18,4,-59,-69,-20,-44,-15,-60,-14,-55,-89,-87,40,-11,FLAT
30,44,9,53,35,37,32,76,27,34,16,30,46,49,33,57,50,78,57,76,2,16,39,80,FLAT
23,41,1,42,53,35,37,32,30,15,26,23,57,49,42,53,76,64,59,80,80,93,83,99,FLAT
3,23,7,30,42,53,35,37,23,9,21,3,53,24,47,26,80,58,63,56,99,73,80,83,FLAT
35,42,17,59,30,42,53,35,3,45,16,35,26,54,37,38,56,69,63,61,83,103,79,91,FLAT
-17,9,28,37,59,30,42,53,35,-6,16,-17,38,39,32,18,61,48,53,21,91,63,79,44,FLAT
32,41,4,45,37,59,30,42,-17,8,0,32,18,2,16,15,21,47,32,50,44,56,53,53,FLAT
0,27,8,35,23,26,21,30,9,-1,-13,0,16,15,6,9,7,10,-4,16,-17,-15,-20,7,FLAT
-18,9,18,27,35,23,26,21,0,-8,0,-18,9,-9,-13,-18,16,7,6,-9,7,2,-4,-2,FLAT
0,22,14,36,27,35,23,26,-18,-4,-13,0,-18,-12,-13,-18,-9,-13,-26,-18,-2,3,-7,-9,FLAT
-21,0,23,23,36,27,35,23,0,-12,1,-21,-18,-16,-12,-21,-18,-24,-12,-39,-9,-25,-25,-39,FLAT
15,24,3,27,23,36,27,35,-21,-5,-9,15,-21,-17,-8,-6,-39,-21,-21,-6,-39,-29,-21,-24,FLAT
3,32,4,36,27,23,36,27,15,4,-5,3,-6,-1,-14,18,-6,-13,-13,-3,-24,-17,-26,-3,FLAT
39,45,2,47,26,36,27,23,15,35,14,39,18,52,41,54,33,56,36,57,12,51,27,72,FLAT
0,37,11,48,47,26,36,27,39,9,8,0,54,44,22,39,57,61,49,54,72,65,44,57,FLAT
-72,9,84,93,72,48,47,26,-47,-35,-56,-72,-47,-46,-91,-119,-8,-37,-83,-119,7,-2,-69,-80,FLAT
21,22,21,43,93,72,48,47,-72,-42,8,21,-119,-77,-48,-51,-119,-88,-83,-98,-80,-79,-75,-98,FLAT
-11,7,42,49,43,93,72,48,21,10,4,-11,-51,-32,12,10,-98,-67,-44,-62,-98,-78,-79,-109,FLAT
6,41,20,61,49,43,93,72,-11,-16,-28,6,10,-6,-24,-5,-62,-48,-16,16,-109,-83,-72,-56,FLAT
-21,15,36,51,61,49,43,93,6,-5,5,-21,-5,-21,-23,-15,16,-11,-19,-26,-56,-53,-11,-5,FLAT
39,67,58,125,51,61,49,43,-21,61,-13,39,-15,56,-8,18,-26,40,-36,24,-5,50,-32,13,FLAT
-26,40,28,68,125,51,61,49,39,-56,1,-26,18,5,-12,13,24,0,-7,-8,13,-16,-35,-2,FLAT
42,43,24,67,68,125,51,61,-26,38,39,42,13,-18,40,16,-8,43,27,55,-2,38,32,34,FLAT
36,54,17,71,67,68,125,51,42,29,25,36,16,67,64,78,55,11,65,52,34,72,52,91,FLAT
-27,3,28,31,63,100,71,67,-31,-35,-3,-27,-74,-74,-5,-58,-38,-90,-50,-101,4,-61,-25,-65,FLAT
-2,28,19,47,31,63,100,71,-27,-11,-27,-2,-58,-46,-30,-29,-101,-85,-32,-60,-65,-101,-77,-103,FLAT
-82,16,82,98,47,31,63,100,-2,-19,-70,-82,-29,-30,-97,-84,-60,-65,-100,-111,-103,-104,-102,-142,FLAT
-79,6,108,114,98,47,31,63,-82,-53,-69,-79,-84,-72,-139,-161,-111,-83,-166,-163,-142,-118,-169,-190,FLAT
56,91,2,93,114,98,47,31,-79,-50,-29,56,-161,-103,-98,-23,-163,-122,-168,-105,-190,-133,-195,-107,FLAT
16,46,1,47,35,44,93,114,21,12,0,16,18,29,26,37,74,33,79,34,-5,-17,50,90,FLAT
9,35,10,45,47,35,44,93,16,18,20,9,37,30,20,25,34,47,46,46,90,51,99,43,FLAT
6,34,10,44,45,47,35,44,9,6,7,6,25,24,27,15,46,36,27,31,43,53,53,52,FLAT
29,37,21,58,44,45,47,35,6,40,26,29,15,46,33,35,31,64,53,44,52,76,53,60,FLAT
-28,11,61,72,58,44,45,47,29,12,-2,-28,35,52,24,1,44,58,31,7,60,76,51,16,FLAT
38,55,1,56,72,58,44,45,-28,-22,-6,38,1,-10,-8,10,7,30,18,39,16,36,25,45,FLAT
4,31,41,72,56,72,58,44,38,44,28,4,10,22,22,42,39,34,20,14,45,74,46,43,FLAT
-19,31,19,50,72,56,72,58,4,-41,-19,-19,42,3,9,-15,14,-19,3,23,43,-7,1,-5,FLAT
24,36,1,37,50,72,56,72,-19,6,19,24,-15,-35,0,5,23,9,28,9,-5,-13,22,47,FLAT
-26,8,29,37,37,50,72,56,24,2,2,-26,5,8,21,-2,9,-33,2,-21,47,11,30,-17,FLAT
-37,13,46,59,35,65,37,37,-6,-7,-31,-37,-13,-4,2,-43,-39,-33,-55,-50,-15,-31,-53,-76,FLAT
-55,1,68,69,59,35,65,37,-37,-33,-43,-55,-43,-40,-74,-92,-50,-37,-41,-98,-76,-66,-98,-105,FLAT
66,71,5,76,69,59,35,65,-55,3,-4,66,-92,-30,-47,11,-98,-37,-78,-26,-105,-34,-45,-32,FLAT
0,22,28,50,76,69,59,35,66,23,49,0,11,26,45,66,-26,-7,2,11,-32,-14,-29,-26,FLAT
35,59,33,92,50,76,69,59,0,40,-2,35,66,63,47,35,11,66,43,101,-26,33,0,46,FLAT
14,23,21,44,92,50,76,69,35,2,50,14,35,42,48,49,101,65,97,49,46,68,93,115,FLAT
31,31,16,47,44,92,50,76,14,26,23,31,49,28,73,45,49,68,71,80,115,91,120,80,FLAT
-26,2,68,70,55,45,47,44,-36,-5,-20,-26,-54,-21,-46,-62,-23,-28,-51,-80,-9,-2,-28,-49,FLAT
18,31,6,37,70,55,45,47,-26,-44,-11,18,-62,-49,-31,-8,-80,-65,-57,-44,-49,-72,-62,-62,FLAT
-25,25,28,53,37,70,55,45,18,-3,-19,-25,-8,-47,-30,-7,-44,-52,-50,-33,-62,-68,-76,-69,FLAT
-26,3,28,31,53,37,70,55,-25,-26,-4,-26,-7,-29,-23,-51,-33,-73,-34,-33,-69,-78,-54,-59,FLAT
9,13,3,16,31,53,37,70,-26,-16,-1,9,-51,-42,-5,-17,-33,-45,-24,-42,-59,-89,-35,-24,FLAT
10,11,3,14,16,31,53,37,9,10,12,10,-17,-6,11,19,-42,-32,7,-7,-24,-35,-12,-32,FLAT
8,11,4,15,14,16,31,53,10,9,8,8,19,19,20,18,-7,3,19,27,-32,-23,15,1,FLAT
-14,1,17,18,15,14,16,31,8,-1,-4,-14,18,8,4,-6,27,18,16,4,1,2,15,13,FLAT
-30,10,32,42,37,26,25,47,21,-3,-8,-30,6,8,-8,-9,4,-8,-25,-24,33,-8,-3,-26,FLAT
-26,4,32,36,42,37,26,25,-30,-26,-20,-26,-9,-29,-28,-56,-24,-18,-28,-35,-26,-34,-45,-50,FLAT
20,30,5,35,36,42,37,26,-26,-7,-6,20,-56,-33,-26,-6,-35,-36,-34,-36,-50,-25,-34,-15,FLAT
-42,2,42,44,35,36,42,37,20,-5,-14,-42,-6,-12,-20,-22,-36,-38,-40,-48,-15,-41,-48,-78,FLAT
-11,11,20,31,44,35,36,42,-42,-33,-20,-11,-22,-38,-34,-53,-48,-45,-40,-33,-78,-71,-60,-59,FLAT
30,43,17,60,59,34,31,44,24,47,46,30,38,62,36,54,27,65,36,68,-15,32,16,57,FLAT
55,65,0,65,60,59,34,31,30,38,33,55,54,85,79,85,68,100,69,109,57,103,69,123,FLAT
-43,12,55,67,65,60,59,34,55,12,10,-43,85,50,43,12,109,97,89,42,123,112,79,66,FLAT
104,104,1,105,67,65,60,59,-43,50,12,104,12,62,22,61,42,100,55,116,66,147,101,146,FLAT
-64,22,65,87,64,105,67,65,-41,-40,-63,-64,63,-41,-23,-105,20,9,-11,-1,75,21,-1,-44,FLAT
62,129,15,144,87,64,105,67,-64,12,-45,62,-105,-28,-108,-2,-1,-29,-68,-43,-44,21,-56,61,FLAT
53,77,19,96,144,87,64,105,62,57,105,53,-2,69,60,115,-43,29,-3,51,61,28,37,10,FLAT
60,66,69,135,96,144,87,64,53,110,71,60,115,167,176,113,51,179,131,175,10,139,68,111,FLAT
46,87,24,111,135,96,144,87,60,1,25,46,113,111,96,106,175,168,201,159,111,180,156,221,FLAT
13,36,12,48,87,111,135,96,-49,-34,5,13,-3,-48,15,-36,57,-47,40,10,110,63,111,70,FLAT
-15,65,19,84,48,87,111,135,13,-8,-44,-15,-36,-42,-39,-2,10,-56,-29,-51,70,-55,-4,-5,FLAT
-8,62,25,87,84,48,87,111,-15,-2,-5,-8,-2,-10,-49,-23,-51,-44,-44,-10,-5,-58,-34,-59,FLAT
-57,0,79,79,87,84,48,87,-8,-3,5,-57,-23,-5,0,-65,-10,-13,-44,-80,-59,-47,-39,-67,FLAT
-25,38,27,65,79,87,84,48,-57,-77,-63,-25,-65,-80,-58,-82,-80,-82,-63,-90,-67,-90,-107,-105,FLAT
-32,10,61,71,65,79,87,84,-25,2,-4,-32,-82,-75,-67,-57,-90,-78,-62,-114,-105,-80,-67,-122,FLAT
-13,25,26,51,71,65,79,87,-32,-48,-28,-13,-57,-46,-32,-45,-114,-123,-95,-70,-122,-126,-90,-127,FLAT
54,59,21,80,51,71,65,79,-13,49,20,54,-45,1,-8,41,-70,3,-12,9,-127,-74,-75,-16,FLAT
0,19,31,50,80,51,71,65,54,10,40,0,41,59,60,54,9,11,32,41,-16,13,28,9,FLAT
15,25,22,47,50,80,51,71,0,6,9,15,54,16,49,15,41,65,69,69,9,17,41,56,FLAT
-39,10,45,55,47,50,80,51,15,-16,-24,-39,15,-10,-15,-24,69,0,25,-24,56,49,45,30,FLAT
-11,1,51,52,55,47,50,80,-39,-5,-2,-11,-24,-21,-26,-50,-24,-15,-17,-35,30,-5,23,-35,FLAT
0,16,31,47,52,55,47,50,-11,-20,-15,0,-50,-25,-17,-11,-35,-41,-41,-50,-35,-35,-32,-35,FLAT
23,74,16,90,47,52,55,47,0,8,-35,23,-11,-12,-50,23,-50,-17,-52,12,-35,-33,-76,-27,FLAT
-7,51,21,72,90,47,52,55,23,-2,16,-7,23,6,-19,16,12,-14,-34,16,-27,-19,-36,5,FLAT
56,60,0,60,72,90,47,52,-7,35,47,56,16,33,63,49,16,41,28,72,5,21,13,72,FLAT
-68,2,83,85,60,72,90,47,56,15,-10,-68,49,50,37,-12,72,48,53,-19,72,56,18,4,FLAT
-89,15,92,107,85,60,72,90,-68,-80,-102,-89,-12,-65,-112,-157,-19,-30,-65,-101,4,-32,-49,-108,FLAT
8,73,17,90,107,85,60,72,-89,-67,-50,8,-157,-147,-152,-81,-101,-132,-162,-149,-108,-97,-115,-93,FLAT
-115,17,123,140,90,107,85,60,8,-9,-59,-115,-81,-76,-109,-107,-149,-156,-211,-196,-93,-141,-221,-264,FLAT
61,77,1,78,140,90,107,85,-115,-61,1,61,-107,-70,-58,-54,-196,-137,-108,-46,-264,-217,-210,-135,FLAT
-6,27,112,139,78,140,90,107,61,105,44,-6,-54,44,45,55,-46,35,-14,-60,-135,-32,-64,-52,FLAT
32,51,23,74,139,78,140,90,-6,-57,8,32,55,48,52,26,-60,-13,53,87,-52,-22,-6,-28,FLAT
18,55,24,79,74,139,78,140,32,19,14,18,26,-38,22,50,87,67,66,44,-28,6,67,105,FLAT
-165,20,168,188,79,74,139,78,18,-21,-130,-165,50,-2,-116,-147,44,-59,-108,-115,105,46,-64,-121,FLAT
-32,21,68,89,188,79,74,139,-165,-132,-33,-32,-147,-153,-163,-197,-115,-134,-149,-179,-121,-191,-141,-147,FLAT
26,92,16,108,89,188,79,74,-32,-26,-45,26,-197,-158,-78,-6,-179,-179,-208,-171,-147,-160,-194,-153,FLAT
72,82,12,94,108,89,188,79,26,68,82,72,-6,42,37,98,-171,-90,4,66,-153,-111,-126,-99,FLAT
-38,13,48,61,94,108,89,188,72,-2,31,-38,98,66,113,34,66,40,68,60,-99,-92,35,28,FLAT
-29,8,62,70,61,94,108,89,-38,-15,-24,-29,34,-17,7,-67,60,51,89,5,28,25,44,31,FLAT
-21,3,50,53,70,61,94,108,-29,-33,-16,-21,-67,-48,-40,-50,5,-50,-9,-88,31,18,73,-16,FLAT
23,67,2,69,53,70,61,94,-21,-25,-41,23,-50,-58,-57,2,-88,-73,-81,-27,-16,-75,-50,-65,FLAT
60,60,1,61,69,53,70,61,23,59,67,60,2,34,26,83,-27,1,10,62,-65,-14,-14,33,FLAT
48,49,7,56,61,69,53,70,60,54,59,48,83,113,126,108,62,88,85,131,33,55,69,110,FLAT
22,37,12,49,56,61,69,53,48,27,34,22,108,81,93,70,131,140,160,130,110,115,119,153,FLAT
-20,1,37,38,49,56,61,69,22,5,16,-20,70,32,50,2,130,86,109,50,153,145,176,110,FLAT
27,37,11,48,38,49,56,61,-20,1,-9,27,2,6,7,7,50,33,41,29,110,87,100,77,FLAT
-16,10,26,36,48,38,49,56,27,-1,11,-16,7,0,2,11,29,5,18,-9,77,32,52,13,FLAT
13,32,3,35,36,48,38,49,-16,-10,-9,13,11,-11,2,-3,-9,-10,-7,24,13,-5,9,4,FLAT
3,6,10,16,23,19,39,33,9,6,13,3,2,6,9,12,21,-4,19,5,17,8,25,24,FLAT
2,10,9,19,16,23,19,39,3,1,-2,2,12,7,11,5,5,7,7,14,24,-3,17,7,FLAT
35,42,3,45,19,16,23,19,2,29,3,35,5,30,1,37,14,36,14,40,7,36,10,49,FLAT
-6,5,16,21,45,19,16,23,35,7,31,-6,37,36,34,29,40,37,32,31,49,43,45,34,FLAT
-17,10,18,28,21,45,19,16,-6,-15,-22,-17,29,-8,9,-23,31,21,12,12,34,22,10,14,FLAT
-5,18,19,37,28,21,45,19,-17,-4,-13,-5,-23,-19,-35,-22,12,-12,-4,-28,14,17,-1,7,FLAT
-15,15,25,40,37,28,21,45,-5,-9,-12,-15,-22,-13,-25,-20,-28,-28,-47,-37,7,-21,-16,-43,FLAT
-33,2,33,35,40,37,28,21,-15,-25,-20,-33,-20,-34,-32,-48,-37,-38,-45,-53,-43,-53,-67,-70,FLAT
14,20,17,37,35,40,37,28,-33,-2,-4,14,-48,-27,-24,-19,-53,-36,-36,-34,-70,-40,-49,-39,FLAT
2,70,33,103,37,35,40,37,14,18,-48,2,-19,16,-52,16,-34,-9,-72,-17,-39,-18,-84,-32,FLAT
12,36,13,49,103,37,35,40,2,-8,46,12,16,10,-2,14,-17,8,-6,28,-32,-17,-26,-5,FLAT
-39,15,70,85,49,103,37,35,12,18,-18,-39,14,10,28,-27,28,28,-20,-25,-5,26,-24,-11,FLAT
3,27,19,46,85,49,103,37,-39,-48,-9,3,-27,-30,-27,-36,-25,-38,19,-24,-11,-20,-29,-22,FLAT
32,44,27,71,46,85,49,103,3,40,15,32,-36,-8,6,35,-24,10,-12,-4,-22,2,34,8,FLAT
26,46,0,46,71,46,85,49,32,-1,24,26,35,39,39,58,-4,-9,30,61,8,9,12,22,FLAT
33,47,3,50,46,71,46,85,26,36,32,33,58,35,56,59,61,75,71,91,22,27,62,94,FLAT
-63,2,68,70,50,46,71,46,33,2,-18,-63,59,38,14,-30,91,37,38,-4,94,77,53,28,FLAT
99,134,13,147,70,50,46,71,-63,44,-33,99,-30,46,-51,36,-4,82,-19,69,28,81,5,95,FLAT
47,47,24,71,147,70,50,46,99,58,134,47,36,102,101,146,69,104,83,83,95,140,115,116,FLAT
-46,0,109,109,71,147,70,50,47,39,1,-46,146,97,135,1,83,141,102,100,116,143,84,37,FLAT
19,27,25,52,109,71,147,70,-46,-65,-8,19,1,-26,-7,-27,100,32,127,20,37,76,94,119,FLAT
-63,18,88,106,52,109,71,147,19,0,-54,-63,-27,-65,-62,-44,20,-26,-61,-90,119,32,73,-43,FLAT
91,94,2,96,106,52,109,71,-63,5,15,91,-44,5,-39,28,-90,-60,-47,47,-43,-21,-46,1,FLAT
-36,10,57,67,96,106,52,109,91,19,48,-36,28,24,63,55,47,24,9,-8,1,-41,1,11,FLAT
-74,2,80,82,67,96,106,52,-36,-51,-66,-74,55,-32,-18,-110,-8,-27,-3,-19,11,-27,-57,-82,FLAT
35,66,6,72,82,67,96,106,-74,-39,-29,35,-110,-90,-95,-39,-19,-71,-47,-75,-82,-66,-32,16,FLAT
22,22,25,47,72,82,67,96,35,41,66,22,-39,2,37,57,-75,-49,-29,-17,16,-30,19,-53,FLAT
-31,8,66,74,47,72,82,67,22,10,-17,-31,57,51,49,-9,-17,12,20,26,-53,-39,-46,-48,FLAT
-7,15,32,47,74,47,72,82,-31,-41,-14,-7,-9,-31,-31,-38,26,10,35,-16,-48,-29,6,19,FLAT
-14,9,41,50,47,74,47,72,-7,-5,-8,-14,-38,-46,-22,-21,-16,-36,-39,-52,19,5,27,-30,FLAT
12,15,28,43,50,47,74,47,-14,-1,6,12,-21,-6,-2,-2,-52,-47,-16,-9,-30,-37,-33,-40,FLAT
20,23,14,37,43,50,47,74,12,6,12,20,-2,5,18,32,-9,0,10,18,-40,-41,-4,11,FLAT
41,68,24,92,37,43,50,47,20,51,-4,41,32,57,8,61,18,56,14,73,11,51,6,59,FLAT
-48,9,51,60,92,37,43,50,41,-21,11,-48,61,30,7,-7,73,36,19,13,59,35,25,25,FLAT
-54,29,78,107,60,92,37,43,-48,-27,-74,-54,-7,-48,-63,-102,13,3,-67,-61,25,9,-55,-41,FLAT
6,66,87,153,107,60,92,37,-54,15,-31,6,-102,-12,-105,-48,-61,-33,-94,-96,-41,18,-98,-55,FLAT
104,110,4,114,153,107,60,92,6,21,60,104,-48,36,29,110,-96,9,-45,56,-55,-12,-34,8,FLAT
-64,37,67,104,114,153,107,60,104,-1,9,-64,110,20,69,40,56,35,38,46,8,8,-36,-8,FLAT
18,30,32,62,104,114,153,107,-64,-17,25,18,40,-18,34,-46,46,3,94,58,-8,18,63,64,FLAT
-65,24,65,89,62,104,114,153,18,-32,-59,-65,-46,-49,-34,-47,58,-50,-25,-111,64,-29,35,-7,FLAT
125,162,43,205,89,62,104,114,-65,103,-13,125,-47,71,-72,60,-111,54,-47,78,-7,53,-38,14,FLAT
166,172,0,172,70,205,89,62,16,149,47,166,141,139,172,182,76,242,159,307,94,210,100,242,FLAT
142,148,51,199,172,70,205,89,166,193,166,142,182,342,213,308,307,332,338,324,242,435,325,449,FLAT
-44,27,51,78,199,172,70,205,142,-44,77,-44,308,149,243,98,324,298,290,264,449,288,415,280,FLAT
-86,28,93,121,78,199,172,70,-44,-44,-87,-86,98,-88,-10,-130,264,105,156,12,280,254,203,178,FLAT
-3,22,25,47,62,65,121,78,8,-32,-17,-3,49,6,24,5,-37,-22,52,46,-81,-66,-35,-40,FLAT
36,45,26,71,47,62,65,121,-3,37,13,36,5,5,-4,33,46,43,37,41,-40,15,65,82,FLAT
84,89,14,103,71,47,62,65,36,72,40,84,33,109,53,120,41,77,36,117,82,115,77,125,FLAT
61,65,10,75,103,71,47,62,84,57,85,61,120,129,125,145,117,166,138,181,125,134,121,178,FLAT
18,25,32,57,75,103,71,47,61,40,58,18,145,97,143,79,181,169,183,163,178,206,196,199,FLAT
16,51,14,65,57,75,103,71,18,-2,-10,16,79,38,48,34,163,95,133,95,199,167,173,179,FLAT
12,26,21,47,65,57,75,103,16,19,37,12,34,17,27,28,95,57,85,46,179,114,170,107,FLAT
23,29,2,31,47,65,57,75,12,4,20,23,28,23,57,35,46,21,47,51,107,61,105,69,FLAT
17,17,20,37,31,47,65,57,23,35,29,17,35,39,49,40,51,58,86,52,69,56,76,68,FLAT
-1,10,2,12,26,20,20,19,13,-9,5,-1,5,0,8,12,-4,-13,-5,4,5,-4,3,-5,FLAT
-11,7,20,27,12,26,20,20,-1,7,-8,-11,12,-2,-3,-12,4,7,0,1,-5,-6,-13,-7,FLAT
-30,1,37,38,27,12,26,20,-11,-13,-24,-30,-12,-6,-32,-41,1,-15,-27,-42,-7,-6,-24,-29,FLAT
3,24,0,24,38,27,12,26,-30,-34,-20,3,-41,-47,-44,-27,-42,-40,-52,-38,-29,-49,-47,-39,FLAT
-21,5,24,29,24,38,27,12,3,3,-2,-21,-27,-31,-22,-18,-38,-44,-46,-48,-39,-37,-54,-59,FLAT
-5,12,18,30,29,24,38,27,-21,-11,-12,-5,-18,-8,-14,-26,-48,-42,-34,-23,-59,-55,-58,-53,FLAT
19,35,1,36,30,29,24,38,-5,2,-4,19,-26,-9,-16,14,-23,-6,-18,-7,-53,-40,-38,-4,FLAT
-11,13,15,28,36,30,29,24,19,3,11,-11,14,5,7,8,-7,-6,-5,3,-4,-3,-7,-18,FLAT
-15,10,47,57,28,36,30,29,-11,17,-12,-15,8,20,-1,-26,3,22,-5,-7,-18,11,-17,-12,FLAT
-13,12,60,72,57,28,36,30,-15,0,-15,-13,-26,17,-27,-28,-7,20,-16,-39,-12,22,-20,-20,FLAT
-1,28,17,45,72,57,28,36,-13,-44,-17,-1,-28,-44,-32,-14,-39,-27,-44,-29,-20,-24,-33,-40,FLAT
-17,5,51,56,45,72,57,28,-1,17,6,-17,-14,-27,-11,-18,-29,-27,-26,-31,-40,-10,-38,-46,FLAT
-1,19,9,28,56,45,72,57,-17,-43,-15,-1,-18,-26,-9,-18,-31,-70,-26,-19,-46,-70,-41,-32,FLAT
45,75,50,125,28,56,45,72,-1,86,-11,45,-18,43,-26,44,-19,60,-20,27,-32,16,-37,26,FLAT
40,71,16,87,125,28,56,45,45,6,44,40,44,92,33,85,27,49,18,84,26,66,24,67,FLAT
73,127,18,145,87,125,28,56,40,75,17,73,85,81,61,113,84,167,50,158,67,124,35,157,FLAT
-41,30,45,75,145,87,125,28,73,-14,56,-41,113,61,73,32,158,67,117,72,157,153,106,117,FLAT
33,56,14,70,75,145,87,125,-41,2,7,33,32,-12,63,-8,72,63,80,65,117,69,124,105,FLAT
-44,1,105,106,70,75,145,87,33,47,11,-44,-8,49,18,-11,65,35,74,-52,105,110,91,21,FLAT
-25,35,33,68,106,70,75,145,-44,-97,-59,-25,-11,-50,-48,-69,-52,-48,-41,-36,21,-62,15,-77,FLAT
22,35,9,44,68,106,70,75,-25,-2,22,22,-69,-99,-37,-3,-36,-52,-26,-47,-77,-50,-19,-14,FLAT
90,98,6,104,44,68,106,70,22,87,27,90,-3,85,49,112,-47,-12,-10,87,-14,35,1,43,FLAT
-44,34,44,78,104,44,68,106,90,-6,20,-44,112,81,47,46,87,79,69,68,43,-18,10,43,FLAT
29,31,35,66,78,104,44,68,-44,20,32,29,46,14,52,-15,68,101,79,75,43,99,101,97,FLAT
15,30,15,45,66,78,104,44,29,-5,16,15,-15,15,48,44,75,9,68,0,97,96,95,90,FLAT
12,29,32,61,45,66,78,104,15,29,13,12,44,24,29,27,0,44,61,56,90,38,81,12,FLAT
40,44,10,54,61,45,66,78,12,18,25,40,27,47,38,52,56,42,54,67,12,62,86,96,FLAT
-36,31,37,68,54,61,45,66,40,-9,-23,-36,52,9,2,4,67,38,15,16,96,33,31,31,FLAT
11,31,26,57,68,54,61,45,-36,0,11,11,4,-9,-12,-25,16,9,13,15,31,38,26,27,FLAT
-81,33,85,118,106,118,57,68,-30,-98,-110,-81,-40,-113,-113,-111,-29,-62,-123,-121,-65,-62,-112,-110,FLAT
-35,11,51,62,118,106,118,57,-81,-69,-13,-35,-111,-167,-123,-116,-121,-182,-126,-146,-110,-131,-136,-156,FLAT
-11,35,47,82,62,118,106,118,-35,-15,-35,-11,-116,-84,-48,-46,-146,-182,-158,-127,-156,-197,-161,-157,FLAT
39,65,22,87,82,62,118,106,-11,14,9,39,-46,-1,-26,28,-127,-70,-39,-7,-157,-168,-149,-88,FLAT
-84,4,185,189,87,82,62,118,39,79,-23,-84,28,93,-14,-45,-7,78,-49,-56,-88,9,-62,-91,FLAT
-10,21,43,64,189,87,82,62,-84,-152,-27,-10,-45,-73,-50,-94,-56,-59,-41,-55,-91,-74,-76,-66,FLAT
-130,9,144,153,64,189,87,82,-10,-29,-118,-130,-94,-181,-145,-140,-55,-102,-168,-224,-66,-88,-159,-185,FLAT
80,93,8,101,153,64,189,87,-130,-56,-4,80,-140,-85,-122,-50,-224,-237,-149,-60,-185,-158,-172,-144,FLAT
8,47,23,70,101,153,64,189,80,23,54,8,-50,-33,50,88,-60,-62,-68,-42,-144,-214,-95,-52,FLAT
32,33,37,70,70,101,153,64,8,46,46,32,88,69,100,40,-42,13,96,120,-52,-16,-22,-10,FLAT
58,109,21,130,70,70,101,153,32,42,-18,58,40,88,28,90,120,111,82,98,-10,55,78,178,FLAT
-89,35,99,134,117,130,70,70,-98,-100,-117,-89,-40,-109,-113,-187,-8,-67,-131,-129,0,-21,-85,-97,FLAT
-94,8,126,134,134,117,130,70,-89,-67,-67,-94,-187,-167,-184,-183,-129,-176,-180,-281,-97,-134,-198,-223,FLAT
70,103,1,104,134,134,117,130,-94,-55,-25,70,-183,-122,-92,-24,-281,-222,-209,-113,-223,-231,-205,-211,FLAT
-134,5,141,146,104,134,134,117,70,6,-36,-134,-24,-49,-61,-64,-113,-116,-128,-158,-211,-216,-245,-247,FLAT
85,91,7,98,146,104,134,134,-134,-49,-1,85,-64,-43,-37,-49,-158,-98,-62,21,-247,-165,-129,-73,FLAT
-86,1,116,117,98,146,104,134,85,23,4,-86,-49,-26,3,-1,21,-20,-33,-135,-73,-75,-58,-65,FLAT
12,54,25,79,117,98,146,104,-86,-79,-41,12,-1,-56,-37,-74,-135,-105,-38,11,-65,-99,-74,-123,FLAT
1,35,29,64,79,117,98,146,12,5,20,1,-74,-74,-21,13,11,-51,-17,-73,-123,-100,-18,12,FLAT
12,41,16,57,64,79,117,98,1,-1,6,12,13,4,26,13,-73,-75,-15,25,12,-52,-11,-61,FLAT
-6,11,23,34,57,64,79,117,12,1,24,-6,13,0,30,6,25,5,50,7,-61,-74,9,19,FLAT
-14,31,20,51,34,57,64,79,-6,-17,-34,-14,6,-16,-10,-20,7,-17,-4,-8,19,-12,16,-7,FLAT
-5,16,19,35,51,34,57,64,-14,-6,10,-5,-20,-23,-24,-19,-8,-22,0,-25,-7,-23,6,-13,FLAT
28,41,0,41,35,51,34,57,-5,9,3,28,-19,3,13,23,-25,-14,-21,9,-13,-13,3,3,FLAT
18,29,8,37,41,35,51,34,28,26,30,18,23,35,33,46,9,29,43,41,3,12,9,27,FLAT
-23,7,38,45,43,18,26,34,-13,-2,-4,-23,-18,-12,-39,-36,-8,-11,-30,-41,-2,-16,-27,-31,FLAT
-28,12,42,54,45,43,18,26,-23,-24,-33,-28,-36,-26,-37,-51,-41,-36,-72,-64,-31,-35,-63,-69,FLAT
4,16,6,22,54,45,43,18,-28,-32,0,4,-51,-56,-33,-24,-64,-58,-37,-47,-69,-68,-72,-60,FLAT
7,50,5,55,22,54,45,43,4,6,-27,7,-24,-26,-27,11,-47,-50,-60,-17,-60,-52,-64,-40,FLAT
-9,39,15,54,55,22,54,45,7,1,2,-9,11,7,-25,-2,-17,-25,-25,2,-40,-49,-58,-26,FLAT
-23,7,34,41,54,55,22,54,-9,-4,9,-23,-2,-3,11,-32,2,3,-16,-25,-26,-29,-16,-21,FLAT
-33,0,50,50,41,54,55,22,-23,-17,-26,-33,-32,-21,-17,-56,-25,-20,-15,-65,-21,-14,-42,-58,FLAT
33,33,16,49,50,41,54,55,-33,-1,0,33,-56,-18,-26,0,-65,-22,-17,-23,-58,-21,-15,-32,FLAT
20,35,8,43,49,50,41,54,33,12,18,20,0,11,18,53,-23,-6,-8,20,-32,-10,1,-3,FLAT
-50,4,51,55,76,62,43,49,-34,-49,-28,-50,-64,-71,-64,-84,-44,-71,-83,-114,-11,-59,-65,-94,FLAT
19,28,34,62,55,76,62,43,-50,2,-5,19,-84,-47,-33,-31,-114,-69,-69,-65,-94,-69,-88,-95,FLAT
-8,25,37,62,62,55,76,62,19,-5,-5,-8,-31,-3,-10,11,-65,-52,-38,-39,-95,-74,-74,-73,FLAT
-431,32,431,463,62,62,55,76,-8,-37,-438,-431,11,-42,-443,-439,-39,-40,-448,-420,-73,-89,-476,-470,FLAT
-122,133,124,257,463,62,62,55,-431,-429,-223,-122,-439,-466,-661,-553,-420,-471,-666,-561,-470,-469,-671,-542,FLAT
17,37,56,93,257,463,62,62,-122,-51,113,17,-553,-480,-110,-105,-561,-517,-548,-536,-542,-522,-553,-544,FLAT
-22,26,80,106,93,257,463,62,17,2,-11,-22,-105,-49,102,-5,-536,-478,-121,-127,-544,-515,-559,-558,FLAT
31,93,33,126,106,93,257,463,-22,-16,-36,31,-5,-14,-47,9,-127,-65,66,26,-558,-494,-157,-96,FLAT
-104,4,106,110,126,106,93,257,31,-31,-15,-104,9,-47,-51,-73,26,-45,-62,-95,-96,-96,51,-78,FLAT
-101,7,154,161,110,126,106,93,-104,-53,-104,-101,-73,-84,-119,-205,-95,-100,-155,-174,-78,-98,-166,-196,FLAT
39,88,8,96,161,110,126,106,-101,-107,-42,39,-205,-160,-146,-62,-174,-191,-161,-166,-196,-207,-197,-135,FLAT
0,35,15,50,96,161,110,126,39,7,53,0,-62,-100,11,39,-166,-153,-93,-62,-135,-184,-108,-166,FLAT
18,19,20,39,107,50,50,96,71,22,90,18,77,95,106,89,77,100,111,95,116,107,164,95,FLAT
34,36,17,53,39,107,50,50,18,31,17,34,89,53,107,52,95,126,123,123,95,131,128,129,FLAT
-9,21,43,64,53,39,107,50,34,17,6,-9,52,48,23,25,123,70,113,43,129,143,129,114,FLAT
32,33,41,74,64,53,39,107,-9,30,20,32,25,47,26,23,43,78,43,57,114,100,133,75,FLAT
47,68,8,76,74,64,53,39,32,14,12,47,23,44,32,79,57,61,38,70,75,92,55,104,FLAT
-27,31,29,60,76,74,64,53,47,-6,10,-27,79,8,22,20,70,38,42,52,104,55,48,43,FLAT
44,44,27,71,60,76,74,64,-27,42,31,44,20,36,41,17,52,50,53,64,43,80,73,96,FLAT
14,42,31,73,71,60,76,74,44,18,16,14,17,60,47,58,64,54,57,31,96,68,69,78,FLAT
91,91,10,101,73,71,60,76,14,70,42,91,58,88,58,105,31,130,89,149,78,124,99,122,FLAT
88,88,18,106,101,73,71,60,91,96,91,88,105,166,133,179,149,184,149,193,122,226,180,237,FLAT
-86,7,102,109,106,101,73,71,88,-2,-5,-86,179,94,86,2,193,164,128,93,237,182,144,107,FLAT
20,66,54,120,109,106,101,73,-86,-28,-39,20,2,-30,-44,-66,93,66,47,22,107,136,89,113,FLAT
44,57,10,67,120,109,106,101,20,0,53,44,-66,-28,14,64,22,-30,9,-22,113,66,100,66,FLAT
56,63,29,92,67,120,109,106,44,75,50,56,64,75,103,100,-22,47,64,120,66,45,59,34,FLAT
-40,18,59,77,92,67,120,109,56,-10,5,-40,100,65,55,16,120,65,108,60,34,37,69,80,FLAT
-101,0,197,197,77,92,67,120,-40,37,-83,-101,16,27,-78,-141,60,102,-28,-85,80,102,25,-41,FLAT
87,112,67,179,197,77,92,67,-101,-43,-25,87,-141,-6,-108,-14,-85,-16,-103,-54,-41,59,-53,2,FLAT
10,69,36,105,179,197,77,92,87,-21,53,10,-14,-64,28,97,-54,-27,-55,-4,2,-37,-50,-44,FLAT
-91,4,108,112,105,179,197,77,10,-19,-26,-91,97,-40,27,-81,-4,-83,2,6,-44,-46,-81,-95,FLAT
-13,37,26,63,112,105,179,197,-91,-95,-46,-13,-81,-114,-72,-104,6,-135,-19,-94,-95,-178,-44,-7,FLAT
-10,14,51,65,63,112,105,179,-13,15,13,-10,-104,-80,-33,-23,-94,-99,-59,-114,-7,-120,-6,-104,FLAT
1,27,50,77,65,63,112,105,-10,0,-12,1,-23,15,1,-9,-114,-80,-45,-22,-104,-99,-71,-113,FLAT
103,113,0,113,77,65,63,112,1,53,17,103,-9,53,5,104,-22,68,18,94,-113,-27,-28,81,FLAT
-58,1,62,63,113,77,65,63,103,4,54,-58,104,57,71,45,94,57,59,46,81,72,72,36,FLAT
-1,34,11,45,63,113,77,65,-58,-52,-34,-1,45,-48,20,-59,46,5,37,44,36,5,25,45,FLAT
20,25,15,40,45,63,113,77,-1,24,29,20,-59,-28,-5,19,44,-24,49,-39,45,29,66,64,FLAT
-2,13,9,22,40,45,63,113,20,-8,10,-2,19,16,39,18,-39,-36,5,17,64,-32,59,-41,FLAT
-21,4,39,43,22,40,45,63,-2,9,-12,-21,18,1,-2,-23,17,25,27,-3,-41,-27,-7,-4,FLAT
82,82,0,82,43,22,40,45,-21,43,4,82,-23,52,-8,61,-3,44,2,59,-4,68,31,79,FLAT
-18,16,24,40,82,43,22,40,82,6,48,-18,61,49,52,64,59,58,40,43,79,50,50,41,FLAT
25,25,17,42,40,82,43,22,-18,18,16,25,64,24,64,7,43,67,68,89,41,76,56,68,FLAT
1,11,13,24,42,40,82,43,25,-3,15,1,7,15,31,26,89,21,79,8,68,64,83,90,FLAT
7,11,6,17,42,34,37,38,-37,-24,1,7,-11,-28,-11,-30,7,-9,11,-4,-30,-17,4,14,FLAT
12,21,11,32,17,42,34,37,7,17,2,12,-30,-7,3,19,-4,-11,-9,-18,14,8,13,8,FLAT
-35,10,44,54,32,17,42,34,12,-2,-24,-35,19,15,-22,-23,-18,-9,-21,-16,8,-13,-33,-53,FLAT
-28,11,29,40,54,32,17,42,-35,-43,-29,-28,-23,-45,-53,-63,-16,-28,-51,-51,-53,-52,-50,-44,FLAT
17,22,4,26,40,54,32,17,-28,-8,6,17,-63,-51,-23,-11,-51,-53,-47,-46,-44,-36,-45,-34,FLAT
28,34,3,37,26,40,54,32,17,27,16,28,-11,19,22,45,-46,-24,-7,17,-34,-26,-31,-18,FLAT
9,9,17,26,37,26,40,54,28,23,34,9,45,50,50,37,17,42,56,54,-18,-1,27,26,FLAT
29,33,6,39,26,37,26,40,9,18,5,29,37,41,39,38,54,68,55,66,26,60,61,83,FLAT
-23,16,29,45,39,26,37,26,29,0,-6,-23,38,18,-1,6,66,41,33,15,83,68,49,43,FLAT
4,28,37,65,45,39,26,37,-23,12,-8,4,6,12,-14,-19,15,30,-9,10,43,53,25,19,FLAT
-50,4,50,54,65,45,39,26,4,-37,-26,-50,-19,-25,-34,-46,10,-25,-40,-69,19,-7,-35,-40,FLAT
-19,28,33,61,54,65,45,39,-50,-36,-43,-19,-46,-73,-69,-69,-69,-61,-77,-65,-40,-61,-83,-88,FLAT
27,32,31,63,61,54,65,45,-19,25,23,27,-69,-11,-20,8,-65,-48,-46,-42,-88,-36,-54,-38,FLAT
-6,7,37,44,63,61,54,65,27,0,19,-6,8,25,42,21,-42,-11,-1,2,-38,-48,-27,-48,FLAT
9,58,50,108,44,63,61,54,-6,22,-42,9,21,22,-23,3,2,47,0,30,-48,11,-43,11,FLAT
-51,28,60,88,108,44,63,61,9,-41,-21,-51,3,-19,-63,-42,30,-19,-44,-48,11,6,-21,-21,FLAT
39,54,35,89,88,108,44,63,-51,14,13,39,-42,-27,-8,-12,-48,-5,-50,-3,-21,-5,-31,-9,FLAT
-95,56,107,163,89,88,108,44,39,-23,-97,-95,-12,-9,-84,-56,-3,-50,-105,-107,-9,-28,-147,-98,FLAT
4,46,15,61,163,89,88,108,-95,-88,14,4,-56,-111,-83,-91,-107,-97,-70,-52,-98,-138,-91,-103,FLAT
-48,8,48,56,61,163,89,88,4,-15,-10,-48,-91,-103,4,-44,-52,-126,-93,-139,-103,-112,-80,-100,FLAT
10,33,16,49,50,55,56,61,25,14,15,10,62,38,44,35,14,40,47,72,18,25,37,24,FLAT
23,38,6,44,49,50,55,56,10,13,18,23,35,27,33,33,72,51,62,58,24,53,65,95,FLAT
-12,5,45,50,44,49,50,55,23,27,21,-12,33,40,39,11,58,54,54,21,95,78,83,46,FLAT
14,41,19,60,50,44,49,50,-12,-12,-22,14,11,15,-1,2,21,28,17,25,46,42,32,35,FLAT
76,88,16,104,60,50,44,49,14,73,29,76,2,61,7,90,25,88,28,78,35,101,46,101,FLAT
-2,23,15,38,104,60,50,44,76,-3,63,-2,90,70,92,74,78,58,70,88,101,85,91,76,FLAT
-10,7,25,32,38,104,60,50,-2,0,6,-10,74,-3,69,-12,88,70,98,64,76,58,76,78,FLAT
19,36,9,45,32,38,104,60,-10,3,-10,19,-12,3,-4,9,64,0,59,7,78,73,88,83,FLAT
-10,20,24,44,45,32,38,104,19,5,6,-10,9,8,-4,9,7,8,2,-1,83,5,65,-3,FLAT
70,80,24,104,44,45,32,38,-10,70,10,70,9,75,16,60,-1,78,6,79,-3,78,12,69,FLAT
53,69,3,72,104,44,45,32,70,32,64,53,60,102,74,123,79,107,80,113,69,110,70,132,FLAT
-9,26,29,55,72,104,44,45,53,17,34,-9,123,49,98,44,113,119,108,114,132,124,114,104,FLAT
30,36,5,41,55,72,104,44,-9,6,20,30,44,23,54,21,114,55,118,74,104,125,128,144,FLAT
15,46,1,47,56,35,41,55,-15,-5,4,15,-21,-8,-20,0,9,-10,-16,-6,0,-4,4,24,FLAT
-29,21,56,77,66,47,56,35,-52,-35,-46,-29,-37,-26,-56,-81,-52,-31,-52,-66,-58,-34,-76,-81,FLAT
14,45,4,49,77,66,47,56,-29,-38,-10,14,-81,-73,-56,-15,-66,-64,-66,-67,-81,-69,-62,-52,FLAT
-29,13,64,77,49,77,66,47,14,31,3,-29,-15,-7,-7,-15,-67,-42,-53,-44,-52,-33,-63,-96,FLAT
5,22,24,46,77,49,77,66,-29,-35,-4,5,-15,-4,-1,-24,-44,-42,-11,-10,-96,-77,-57,-39,FLAT
-62,5,75,80,46,77,49,77,5,-11,-45,-62,-24,-46,-49,-57,-10,-15,-46,-86,-39,-53,-56,-72,FLAT
43,55,70,125,80,46,77,49,-62,38,-7,43,-57,27,-52,-19,-86,-8,-56,-14,-72,23,-53,-43,FLAT
31,57,0,57,125,80,46,77,43,-39,29,31,-19,-1,22,74,-14,-12,-23,12,-43,-47,-27,17,FLAT
21,41,15,56,57,125,80,46,31,36,37,21,74,-3,66,52,12,35,59,95,17,24,14,33,FLAT
17,33,4,37,56,57,125,80,21,6,25,17,52,42,62,38,95,3,91,69,33,41,84,112,FLAT
-56,8,83,91,37,56,57,125,17,23,-31,-56,38,29,-6,-39,69,65,31,-18,112,26,60,13,FLAT
-16,15,17,32,91,37,56,57,-56,-82,-23,-16,-39,-59,-54,-72,-18,-53,-29,-55,13,-17,8,-34,FLAT
-56,1,67,68,32,91,37,56,-16,-6,-42,-56,-72,-88,-65,-72,-55,-65,-96,-128,-34,-59,-71,-111,FLAT
-7,20,9,29,68,32,91,37,-56,-65,-26,-7,-72,-71,-68,-63,-128,-153,-91,-79,-111,-130,-122,-135,FLAT
72,72,12,84,29,68,32,91,-7,75,20,72,-63,10,-6,65,-79,4,-48,9,-135,-78,-71,-7,FLAT
-18,6,25,31,84,29,68,32,72,-5,48,-18,65,70,68,54,9,5,42,47,-7,-1,0,-9,FLAT
56,62,6,68,31,84,29,68,-18,37,0,56,54,32,48,38,47,107,68,110,-9,42,42,103,FLAT
-8,10,14,24,68,31,84,29,56,0,44,-8,38,37,44,48,110,32,92,30,103,107,112,102,FLAT
-19,0,30,30,24,68,31,84,-8,-3,-9,-19,48,-3,35,-27,30,34,35,29,102,29,83,11,FLAT
13,20,2,22,25,36,39,56,-11,0,3,13,-9,-10,4,2,2,-1,16,4,37,10,44,15,FLAT
-8,12,17,29,22,25,36,39,13,7,0,-8,2,7,3,5,4,-3,4,-6,15,6,16,-4,FLAT
-32,2,40,42,25,29,22,25,-7,-2,-19,-32,-15,-16,-29,-39,-2,-9,-29,-47,-13,-9,-26,-34,FLAT
27,29,12,41,42,25,29,22,-32,-1,0,27,-39,-3,-19,-5,-47,-17,-29,-12,-34,-10,-29,-20,FLAT
7,20,6,26,41,42,25,29,27,1,16,7,-5,0,16,34,-12,-2,-3,2,-20,-16,-13,-5,FLAT
-51,4,53,57,26,41,42,25,7,-4,-35,-51,34,-3,-19,-44,2,-4,-19,-17,-5,-6,-38,-49,FLAT
-39,3,62,65,57,26,41,42,-51,-30,-38,-39,-44,-34,-73,-90,-17,-33,-57,-83,-49,-34,-57,-56,FLAT
41,55,5,60,55,89,65,57,28,36,31,41,89,61,90,69,50,73,78,130,-1,43,40,91,FLAT
4,63,25,88,60,55,89,65,41,24,-4,4,69,60,27,45,130,85,86,73,91,97,74,134,FLAT
77,95,11,106,88,60,55,89,4,63,45,77,45,87,41,81,73,123,72,122,134,148,131,150,FLAT
-23,3,50,53,106,88,60,55,77,16,69,-23,81,79,114,54,122,103,110,58,150,139,141,99,FLAT
-3,53,14,67,53,106,88,60,-23,-39,-53,-3,54,-23,16,-26,58,40,61,51,99,64,57,55,FLAT
34,34,19,53,67,53,106,88,-3,39,53,34,-26,0,0,31,51,16,69,8,55,79,114,85,FLAT
8,32,36,68,53,67,53,106,34,25,10,8,31,64,63,42,8,25,10,39,85,41,79,16,FLAT
-1,36,7,43,68,53,67,53,8,-30,-5,-1,42,-5,5,7,39,34,58,41,16,-5,5,38,FLAT
-29,27,37,64,43,68,53,67,-1,1,-20,-29,7,-29,-25,-30,41,-4,-15,-22,38,35,38,12,FLAT
23,35,17,52,64,43,68,53,-29,3,15,23,-30,4,-5,-6,-22,-26,-10,-7,12,-1,0,1,FLAT
-95,10,95,105,52,64,43,68,23,-17,-70,-95,-6,-14,-55,-72,-7,-13,-75,-101,1,-43,-80,-102,FLAT
-4,36,29,65,105,52,64,43,-95,-70,-30,-4,-72,-87,-100,-99,-101,-84,-85,-76,-102,-83,-105,-105,FLAT
48,49,39,88,65,105,52,64,-4,58,35,48,-99,-12,5,44,-76,-29,-65,-51,-105,-26,-50,-28,FLAT
63,65,40,105,88,65,105,52,48,64,47,63,44,122,82,111,-51,52,52,107,-28,35,-18,12,FLAT
28,29,21,50,105,88,65,105,63,9,64,28,111,73,111,91,107,131,146,139,12,61,116,135,FLAT
-21,30,21,51,50,105,88,65,28,-21,-22,-21,91,-12,42,7,139,52,89,70,135,110,124,118,FLAT
47,57,6,63,51,50,105,88,-21,32,20,47,7,11,-2,26,70,20,62,54,118,84,109,117,FLAT
53,57,13,70,63,51,50,105,47,60,53,53,26,92,73,100,54,71,51,79,117,80,115,107,FLAT
-12,28,20,48,70,63,51,50,53,-5,17,-12,100,55,70,41,79,87,90,88,107,66,68,67,FLAT
-49,5,51,56,48,70,63,51,-12,-18,-26,-49,41,-23,-9,-61,88,37,44,-8,67,69,64,39,FLAT
-16,10,32,42,56,48,70,63,-49,-35,-21,-16,-61,-53,-47,-65,-8,-58,-30,-77,39,2,23,-24,FLAT
27,33,31,64,89,53,42,56,83,56,81,27,91,103,92,110,75,117,95,118,26,82,74,102,FLAT
153,259,12,271,64,89,53,42,27,134,-73,153,110,190,8,180,118,237,19,263,102,251,22,271,FLAT
-57,65,59,124,271,64,89,53,153,-10,137,-57,180,124,64,96,263,180,145,123,271,227,156,206,FLAT
-4,33,11,44,124,271,64,89,-57,-52,28,-4,96,-62,165,-61,123,72,92,92,206,128,173,119,FLAT
70,70,10,80,44,124,271,64,-4,69,33,70,-61,17,61,66,92,7,198,9,119,141,125,162,FLAT
37,69,11,80,80,44,124,271,70,38,38,37,66,107,71,107,9,55,99,103,162,45,236,46,FLAT
-216,20,241,261,138,80,80,44,-96,-81,-204,-216,-59,-82,-263,-312,11,-44,-225,-275,7,25,-192,-205,FLAT
152,153,15,168,261,138,80,80,-216,-74,19,152,-312,-155,-185,-64,-275,-156,-244,-160,-205,-118,-206,-123,FLAT
-59,52,113,165,168,261,138,80,152,39,42,-59,-64,-35,61,93,-160,-116,-143,-123,-123,-117,-202,-219,FLAT
-48,14,97,111,165,168,261,138,-59,-64,-10,-48,93,-25,32,-107,-123,-99,51,45,-219,-180,-153,-171,FLAT
-4,27,28,55,111,165,168,261,-48,-73,-17,-4,-107,-137,-27,-52,45,-98,15,-111,-171,-172,34,41,FLAT
64,64,42,106,55,111,165,168,-4,78,27,64,-52,5,10,60,-111,-59,0,12,41,-20,42,-47,FLAT
57,61,23,84,106,55,111,165,64,38,60,57,60,116,87,121,12,43,70,117,-47,-21,60,69,FLAT
-7,23,27,50,84,106,55,111,57,-3,31,-7,121,35,91,50,117,113,118,114,69,40,101,110,FLAT
44,52,13,65,50,84,106,55,-7,30,15,44,50,27,46,37,114,65,106,94,110,143,133,158,FLAT
-33,2,45,47,65,50,84,106,44,-1,17,-33,37,29,32,11,94,26,63,4,158,64,123,61,FLAT
-34,5,42,47,47,65,50,84,-33,-37,-37,-34,11,-38,-20,-67,4,-8,-5,-23,61,-11,26,-30,FLAT
13,13,26,39,47,47,65,50,-34,-3,5,13,-67,-40,-32,-21,-23,-41,-15,-54,-30,-11,0,-10,FLAT
-26,11,35,46,39,47,47,65,13,-17,-24,-26,-21,-20,-19,-13,-54,-57,-56,-47,-10,-58,-39,-80,FLAT
35,35,5,40,46,39,47,47,-26,5,11,35,-13,-12,-13,9,-47,-15,-8,22,-80,-52,-45,-12,FLAT
4,7,17,24,40,46,39,47,35,16,32,4,9,21,43,39,22,4,19,13,-12,1,24,26,FLAT
18,21,21,42,24,40,46,39,4,22,4,18,39,38,36,22,13,43,47,57,26,26,23,31,FLAT
2,7,9,16,40,33,42,30,-11,-17,7,2,-20,-26,-9,-9,16,-9,17,-18,18,11,25,18,FLAT
22,22,4,26,16,40,33,42,2,17,7,22,-9,0,14,24,-18,-9,-2,13,18,8,24,4,FLAT
-39,6,40,46,26,16,40,33,22,-3,-23,-39,24,14,-16,-17,13,-3,-9,-15,4,-12,-25,-26,FLAT
-1,25,7,32,46,26,16,40,-39,-34,-20,-1,-17,-37,-43,-40,-15,-20,-36,-18,-26,-37,-29,-16,FLAT
-6,22,21,43,32,46,26,16,-1,8,-3,-6,-40,-26,-23,-7,-18,-29,-46,-46,-16,-12,-39,-24,FLAT
14,32,4,36,43,32,46,26,-6,-3,4,14,-7,5,1,8,-46,-29,-19,7,-24,-32,-42,-32,FLAT
18,44,2,46,36,43,32,46,14,16,6,18,8,13,10,32,7,21,7,26,-32,-13,-13,25,FLAT
6,23,23,46,46,36,43,32,18,27,27,6,32,43,33,24,26,40,37,38,25,48,34,32,FLAT
10,23,3,26,46,46,36,43,6,-10,10,10,24,17,37,16,38,33,43,34,32,30,47,48,FLAT
-26,4,40,44,26,46,46,36,10,11,-7,-26,16,1,3,-16,34,28,30,-10,48,44,36,8,FLAT
-43,7,73,80,78,44,26,46,-60,-39,-41,-43,-86,-70,-106,-103,-76,-59,-113,-129,-70,-69,-103,-119,FLAT
-26,21,53,74,80,78,44,26,-43,-46,-40,-26,-103,-85,-81,-69,-129,-116,-146,-129,-119,-105,-153,-155,FLAT
15,27,19,46,108,74,80,78,99,25,87,15,73,80,108,114,30,34,68,88,-30,-5,27,45,FLAT
46,64,1,65,46,108,74,80,15,28,9,46,114,53,96,61,88,108,117,160,45,62,77,134,FLAT
-13,22,44,66,65,46,108,74,46,30,29,-13,61,58,38,33,160,83,125,48,134,138,146,147,FLAT
43,82,2,84,66,65,46,108,-13,1,-17,43,33,31,12,30,48,59,21,76,147,84,108,91,FLAT
-72,5,83,88,84,66,65,46,43,9,5,-72,30,10,-12,-29,76,40,17,-42,91,68,26,4,FLAT
86,129,3,132,88,84,66,65,-72,6,-38,86,-29,15,-33,14,-42,16,-50,57,4,46,-21,44,FLAT
-55,1,79,80,132,88,84,66,86,21,73,-55,14,27,35,31,57,36,40,-41,44,37,23,2,FLAT
15,100,27,127,80,132,88,84,-55,-37,-84,15,31,-16,-11,-40,-41,-10,-49,46,2,-1,-44,-26,FLAT
-42,0,89,89,127,80,132,88,15,20,58,-42,-40,-17,-26,-27,46,4,47,-82,-26,10,9,4,FLAT
11,34,19,53,89,127,80,132,-42,-59,-23,11,-27,-39,35,-31,-82,-76,-49,-16,4,-55,24,-71,FLAT
-37,28,58,86,53,89,127,80,11,2,-31,-37,-31,-57,-54,-26,-16,-37,4,-68,-71,-74,-80,-53,FLAT
61,85,30,115,86,53,89,127,-37,33,4,61,-26,35,-27,24,-68,-24,-50,35,-53,-4,8,-7,FLAT
52,52,19,71,115,86,53,89,61,41,85,52,24,74,89,113,35,76,58,76,-7,17,35,87,FLAT
-63,14,75,89,59,74,71,115,-17,-38,-68,-63,-43,-66,-81,-80,9,-50,-68,-106,70,-9,17,-54,FLAT
35,48,25,73,89,59,74,71,-63,-15,1,35,-80,-53,-67,-28,-106,-81,-80,-45,-54,-65,-67,-71,FLAT
-42,5,53,58,73,89,59,74,35,-14,1,-42,-28,-29,2,-7,-45,-67,-66,-70,-71,-95,-79,-87,FLAT
-71,29,81,110,58,73,89,59,-42,-43,-95,-71,-7,-57,-94,-113,-70,-72,-93,-78,-87,-110,-161,-141,FLAT
-79,0,121,121,110,58,73,89,-71,-39,-50,-79,-113,-82,-145,-150,-78,-96,-144,-192,-141,-111,-143,-157,FLAT
-20,22,74,96,121,110,58,73,-79,-67,-42,-20,-150,-106,-92,-99,-192,-149,-187,-170,-157,-163,-186,-212,FLAT
-29,3,56,59,96,121,110,58,-20,-47,-10,-29,-99,-114,-52,-49,-170,-153,-102,-128,-212,-196,-197,-199,FLAT
0,19,56,75,59,96,121,110,-29,0,-16,0,-49,-47,-26,-29,-128,-114,-68,-49,-199,-153,-118,-128,FLAT
-37,2,96,98,75,59,96,121,0,3,-20,-37,-29,3,-36,-37,-49,-44,-46,-66,-128,-111,-88,-86,FLAT
99,100,4,104,98,75,59,96,-37,7,1,99,-37,10,-19,62,-66,10,-35,62,-86,-37,-45,33,FLAT
-36,31,141,172,104,98,75,59,99,101,33,-36,62,108,34,63,62,111,14,26,33,111,-2,26,FLAT
45,106,96,202,172,104,98,75,-36,0,-30,45,63,101,3,9,26,108,4,108,26,111,-16,71,FLAT
-162,36,184,220,202,172,104,98,45,-74,-92,-162,9,-74,-122,-117,108,27,-89,-153,71,34,-88,-54,FLAT
-31,0,140,140,220,202,172,104,-162,-75,5,-31,-117,-149,-87,-193,-153,-149,-117,-148,-54,-48,-84,-184,FLAT
5,13,41,54,140,220,202,172,-31,-94,-8,5,-193,-169,-3,-26,-148,-243,-95,-188,-184,-243,-125,-143,FLAT
-174,19,188,207,54,140,220,202,5,-27,-180,-174,-26,-121,-188,-169,-188,-196,-183,-200,-143,-270,-275,-362,FLAT
153,160,3,163,207,54,140,220,-174,-32,12,153,-169,-59,-168,-21,-200,-153,-176,-16,-362,-228,-171,-47,FLAT
8,22,24,46,163,207,54,140,153,29,146,8,-21,-3,158,161,-16,-30,-22,-13,-47,-124,-30,-8,FLAT
-81,0,81,81,46,163,207,54,8,-24,-59,-81,161,5,87,-73,-13,-27,99,80,-8,-54,-81,-94,FLAT
-30,15,50,65,81,46,163,207,-81,-61,-45,-30,-73,-85,-104,-111,80,-56,42,-103,-94,-88,54,50,FLAT
50,60,19,79,87,65,81,46,81,68,76,50,51,100,86,131,-30,39,41,101,-22,15,-18,20,FLAT
-57,5,57,62,79,87,65,81,50,-19,-2,-57,131,49,74,-7,101,81,84,74,20,20,39,44,FLAT
0,8,32,40,62,79,87,65,-57,-25,-3,0,-7,-44,-5,-57,74,24,71,-7,44,56,81,74,FLAT
51,63,11,74,40,62,79,87,0,30,-4,51,-57,5,-7,51,-7,-14,-9,-6,74,54,67,44,FLAT
2,12,14,26,74,40,62,79,51,5,53,2,51,35,49,53,-6,10,46,53,44,-9,44,-4,FLAT
-5,27,11,38,26,74,40,62,2,-8,-20,-5,53,-3,33,-3,53,27,29,48,-4,2,26,48,FLAT
-8,5,20,25,38,26,74,40,-5,1,14,-8,-3,-7,-6,-13,48,-2,47,-11,48,28,43,40,FLAT
9,26,4,30,36,27,35,52,-20,-7,-1,9,-13,-23,-26,-11,-12,-18,-13,-4,-54,-49,-27,-3,FLAT
-23,9,26,35,30,36,27,35,9,-1,-6,-23,-11,-8,-7,-14,-4,-24,-32,-34,-3,-19,-19,-27,FLAT
-2,5,8,13,35,30,36,27,-23,-20,2,-2,-14,-21,-4,-25,-34,-28,-5,-16,-27,-44,-30,-36,FLAT
-1,6,12,18,13,35,30,36,-2,3,-2,-1,-25,-17,0,-3,-16,-18,-6,-26,-36,-25,-7,-17,FLAT
-51,46,55,101,18,13,35,30,-1,-8,-91,-51,-3,-5,-93,-52,-26,-25,-91,-54,-17,-26,-97,-77,FLAT
-8,11,75,86,40,28,101,18,19,58,12,-8,26,77,19,11,-25,38,53,18,-26,30,-38,-33,FLAT
71,97,0,97,86,40,28,101,-8,-4,-15,71,11,54,-3,63,18,73,4,82,-33,34,38,89,FLAT
18,43,23,66,97,86,40,28,71,41,72,18,63,37,57,89,82,95,69,81,89,114,76,100,FLAT
-38,25,38,63,66,97,86,40,18,-23,-20,-38,89,18,52,-20,81,14,37,51,100,72,49,43,FLAT
29,50,16,66,63,66,97,86,-38,7,4,29,-20,-16,-16,-9,51,25,56,9,43,21,41,80,FLAT
22,29,29,58,66,63,66,97,29,35,43,22,-9,42,47,51,9,19,27,13,80,60,99,31,FLAT
123,123,22,145,58,66,63,66,22,116,29,123,51,151,72,145,13,158,76,174,31,135,56,136,FLAT
66,78,45,123,145,58,66,63,123,89,111,66,145,205,140,189,174,240,183,211,136,247,187,240,FLAT
11,47,24,71,123,145,58,66,66,-10,42,11,189,79,153,77,211,195,182,200,240,230,225,222,FLAT
-7,30,21,51,71,123,145,58,11,-10,10,-7,77,-20,52,4,200,69,163,70,222,185,192,193,FLAT
7,25,45,70,51,71,123,145,-7,31,12,7,4,21,22,0,70,11,64,11,193,100,175,77,FLAT
-38,23,54,77,70,51,71,123,7,-29,-36,-38,0,2,-24,-31,11,-8,-14,-38,77,-18,28,-27,FLAT
57,89,11,100,77,70,51,71,-38,14,-9,57,-31,-15,-45,19,-38,16,-33,26,-27,6,-23,19,FLAT
-50,13,52,65,100,77,70,51,57,-9,26,-50,19,5,17,7,26,-24,-19,-31,19,7,-7,-24,FLAT
11,32,26,58,43,42,45,65,6,23,8,11,12,24,8,17,14,33,20,23,-36,-1,6,25,FLAT
47,51,0,51,58,43,42,45,11,21,28,47,17,44,36,58,23,45,36,64,25,54,48,70,FLAT
17,28,32,60,51,58,43,42,47,49,40,17,58,70,68,64,64,93,76,75,70,94,76,81,FLAT
-11,14,56,70,60,51,58,43,17,13,3,-11,64,62,43,6,75,83,71,53,81,106,79,64,FLAT
56,74,2,76,70,60,51,58,-11,2,-4,56,6,15,-1,45,53,64,39,62,64,85,67,109,FLAT
22,40,7,47,76,70,60,51,56,27,56,22,45,29,52,78,62,42,55,67,109,91,95,84,FLAT
39,46,11,57,47,76,70,60,22,43,33,39,78,70,89,61,67,72,85,117,84,85,88,106,FLAT
14,34,15,49,57,47,76,70,39,18,26,14,61,61,59,53,117,88,115,75,106,90,111,131,FLAT
36,49,9,58,49,57,47,76,14,30,21,36,53,48,47,50,75,91,80,89,131,118,136,111,FLAT
-299,88,299,387,52,58,58,49,-16,-39,-374,-299,-37,-64,-393,-315,-1,-46,-375,-336,13,-16,-354,-300,FLAT
-241,79,252,331,387,52,58,58,-299,-288,-232,-241,-315,-327,-606,-540,-336,-352,-625,-556,-300,-334,-607,-577,FLAT
-88,54,130,184,331,387,52,58,-241,-210,-63,-88,-540,-498,-295,-329,-556,-537,-669,-628,-577,-562,-688,-644,FLAT
-10,7,78,85,184,331,387,52,-88,-62,37,-10,-329,-272,-26,-98,-628,-560,-258,-339,-644,-599,-632,-638,FLAT
-97,13,132,145,85,184,331,387,-10,-43,-103,-97,-98,-105,-66,-107,-339,-315,-129,-195,-638,-603,-361,-436,FLAT
74,87,12,99,145,85,184,331,-97,-46,0,74,-107,-89,-103,-23,-195,-151,-66,-33,-436,-361,-129,-121,FLAT
143,144,3,147,99,145,85,184,74,134,86,143,-23,88,86,217,-33,45,-17,120,-121,-17,20,110,FLAT
82,82,25,107,147,99,145,85,143,104,144,82,217,238,230,225,120,192,230,299,110,149,127,202,FLAT
67,108,20,128,101,107,147,99,-86,-5,-32,67,-4,-24,-45,-19,139,80,99,63,213,214,185,206,FLAT
-42,7,115,122,128,101,107,147,67,53,59,-42,-19,48,27,25,63,29,14,-61,206,133,158,21,FLAT
20,39,19,58,122,128,101,107,-42,-76,-12,20,25,-23,47,-22,-61,-28,15,45,21,-47,2,-41,FLAT
-57,28,58,86,58,122,128,101,20,-18,-46,-57,-22,-94,-58,-37,45,-41,1,-79,-41,-46,-31,-12,FLAT
-12,2,54,56,86,58,122,128,-57,-16,14,-12,-37,-34,-32,-69,-79,-110,-44,-49,-12,-57,15,-91,FLAT
-10,7,42,49,56,86,58,122,-12,-22,-15,-10,-69,-38,-1,-22,-49,-56,-47,-79,-91,-132,-59,-59,FLAT
-5,25,11,36,49,56,86,58,-10,-36,-23,-5,-22,-58,-38,-15,-79,-74,-24,-27,-59,-92,-70,-84,FLAT
-30,2,35,37,36,49,56,86,-5,-6,-7,-30,-15,-42,-30,-35,-27,-64,-45,-45,-84,-80,-31,-57,FLAT
-53,20,57,77,37,36,49,56,-30,-31,-71,-53,-35,-37,-78,-83,-45,-73,-101,-88,-57,-95,-116,-98,FLAT
6,28,17,45,77,37,36,49,-53,-34,-2,6,-83,-65,-73,-47,-88,-71,-80,-77,-98,-107,-103,-82,FLAT
26,55,5,60,45,77,37,36,6,14,-1,26,-47,-20,-3,32,-77,-51,-74,-21,-82,-57,-81,-51,FLAT
-13,5,25,30,60,45,77,37,26,7,37,-13,32,21,36,13,-21,-13,34,19,-51,-44,-37,-34,FLAT
0,14,10,24,30,60,45,77,-13,-15,-9,0,13,-8,28,-13,19,6,27,13,-34,-28,25,19,FLAT
-10,4,36,40,52,29,32,45,44,21,33,-10,52,58,47,34,58,59,51,42,15,40,45,48,FLAT
15,17,4,21,40,52,29,32,-10,-17,2,15,34,4,35,5,42,41,49,49,48,42,53,57,FLAT
-3,14,13,27,21,40,52,29,15,6,0,-3,5,-11,2,12,49,10,35,2,57,47,49,46,FLAT
-28,14,32,46,27,21,40,52,-3,-9,-28,-28,12,-3,-28,-31,2,-20,-26,-16,46,1,7,-26,FLAT
2,20,10,30,46,27,21,40,-28,-20,-4,2,-31,-29,-32,-26,-16,-23,-32,-29,-26,-40,-30,-14,FLAT
-11,20,24,44,30,46,27,21,2,3,-11,-11,-26,-17,-15,-9,-29,-26,-43,-37,-14,-20,-43,-40,FLAT
34,39,5,44,44,30,46,27,-11,15,15,34,-9,18,4,23,-37,-2,0,25,-40,-11,-28,-3,FLAT
17,24,16,40,44,44,30,46,34,28,32,17,23,43,47,51,25,46,36,40,-3,26,32,42,FLAT
-45,16,59,75,40,44,44,30,17,-2,-37,-45,51,26,-5,-28,40,41,10,6,42,44,-1,-5,FLAT
-53,42,57,99,75,40,44,44,-45,-55,-79,-53,-28,-57,-116,-98,6,-29,-84,-81,-5,-14,-69,-47,FLAT
-53,21,60,81,99,75,40,44,-53,-50,-32,-53,-98,-105,-111,-106,-81,-107,-148,-151,-47,-79,-116,-134,FLAT
51,51,22,73,81,99,75,40,-53,13,21,51,-106,-37,-11,-2,-151,-92,-90,-55,-134,-94,-127,-100,FLAT
1,57,10,67,73,81,99,75,51,-11,-5,1,-2,2,16,52,-55,-48,-16,-1,-100,-103,-95,-54,FLAT
-11,76,31,107,67,73,81,99,1,10,-30,-11,52,-1,-35,-10,-1,12,-14,41,-54,-38,-46,-12,FLAT
48,74,17,91,107,67,73,81,-11,34,50,48,-10,44,20,37,41,33,15,38,-12,46,36,89,FLAT
-31,30,52,82,99,91,107,67,-82,-78,-61,-31,-34,-78,-69,-113,-45,-44,-19,-65,-44,-34,-49,-76,FLAT
-48,15,52,67,82,99,91,107,-31,-48,-33,-48,-113,-126,-94,-79,-65,-126,-102,-161,-76,-92,-52,-113,FLAT
-79,22,111,133,67,82,99,91,-48,-20,-86,-79,-79,-68,-119,-127,-161,-146,-180,-158,-113,-146,-188,-240,FLAT
-33,53,37,90,133,67,82,99,-79,-107,-64,-33,-127,-127,-150,-112,-158,-175,-183,-160,-240,-253,-244,-191,FLAT
-16,13,31,44,90,133,67,82,-33,-22,24,-16,-112,-129,-40,-49,-160,-149,-126,-128,-191,-197,-159,-176,FLAT
31,46,6,52,58,90,44,90,26,29,35,31,49,26,64,57,33,55,47,80,0,33,71,64,FLAT
-11,10,36,46,52,58,90,44,31,19,25,-11,57,48,60,20,80,45,89,46,64,74,72,69,FLAT
-17,18,31,49,46,52,58,90,-11,-22,-25,-17,20,-3,0,-28,46,26,35,3,69,23,64,29,FLAT
-18,12,25,37,49,46,52,58,-17,-24,-12,-18,-28,-46,-37,-35,3,-27,-12,-46,29,2,23,-15,FLAT
62,75,5,80,57,37,49,46,49,64,41,62,31,91,48,111,14,67,36,93,3,45,11,76,FLAT
-2,39,20,59,80,57,37,49,62,13,34,-2,111,77,75,60,93,104,82,109,76,80,70,91,FLAT
-21,18,33,51,59,80,57,37,-2,-8,0,-21,60,5,34,-23,109,69,75,39,91,96,82,88,FLAT
22,26,21,47,51,59,80,57,-21,10,14,22,-23,2,14,1,39,15,48,-1,88,79,89,61,FLAT
4,11,56,67,47,51,59,80,22,39,19,4,1,49,33,26,-1,41,33,5,61,54,67,3,FLAT
169,175,22,197,67,47,51,59,4,135,5,169,26,174,24,173,5,184,38,195,3,176,38,174,FLAT
14,42,44,86,197,67,47,51,169,36,147,14,173,171,152,183,195,210,171,187,174,220,185,209,FLAT
179,181,42,223,86,197,67,47,14,177,40,179,183,213,187,193,187,348,192,362,209,387,211,366,FLAT
73,93,6,99,223,86,197,67,179,37,161,73,193,214,201,252,362,250,348,266,366,385,353,435,FLAT
75,84,3,87,99,223,86,197,73,72,84,75,252,109,245,148,266,286,285,327,435,322,432,341,FLAT
21,34,32,66,87,99,223,86,75,50,71,21,148,122,155,96,327,159,316,169,341,336,356,348,FLAT
36,137,35,172,66,87,99,223,21,39,-67,36,96,89,4,57,169,161,88,132,348,198,249,205,FLAT
40,56,25,81,172,66,87,99,36,30,121,40,57,69,54,76,132,119,125,97,205,191,209,172,FLAT
110,122,15,137,81,172,66,87,40,100,44,110,76,130,165,150,97,169,98,186,172,219,169,207,FLAT
-104,16,156,172,142,99,137,81,-31,-26,-56,-104,-47,-59,-132,-135,63,-10,-45,-151,103,90,-1,-41,FLAT
28,64,57,121,172,142,99,137,-104,-71,-20,28,-135,-97,-76,-76,-151,-130,-152,-107,-41,-81,-65,-123,FLAT
9,42,46,88,121,172,142,99,28,-2,31,9,-76,-73,11,37,-107,-99,-45,-67,-123,-132,-121,-98,FLAT
13,43,5,48,88,121,172,142,9,-28,12,13,37,-30,43,22,-67,-101,23,50,-98,-127,-33,-54,FLAT
39,76,2,78,48,88,121,172,13,36,6,39,22,8,18,52,50,6,49,61,-54,-65,29,89,FLAT
-58,0,91,91,78,48,88,121,39,31,18,-58,52,67,24,-19,61,39,36,-6,89,37,67,3,FLAT
0,5,44,49,91,78,48,88,-58,-47,-5,0,-19,-16,13,-58,-6,20,19,-19,3,-8,31,-6,FLAT
0,1,53,54,49,91,78,48,0,9,4,0,-58,-38,-1,0,-19,-7,17,-58,-6,29,23,-19,FLAT
49,61,1,62,54,49,91,78,0,-3,-11,49,0,6,-7,49,-58,-41,-12,49,-19,-10,6,-9,FLAT
36,41,11,52,62,54,49,91,49,46,56,36,49,43,45,85,49,52,49,85,-9,5,44,85,FLAT
-51,0,54,54,52,62,54,49,36,-8,-10,-51,85,38,46,-15,85,35,35,34,85,44,39,34,FLAT
-50,15,51,66,54,52,62,54,-51,-53,-65,-50,-15,-61,-75,-101,34,-15,-19,-65,34,-18,-30,-16,FLAT
-1,19,7,26,66,54,52,62,-50,-45,-5,-1,-101,-98,-70,-51,-65,-106,-80,-102,-16,-60,-24,-66,FLAT
8,20,10,30,53,22,25,28,44,13,36,8,34,41,33,52,45,49,44,42,28,40,38,53,FLAT
14,17,4,21,30,53,22,25,8,8,17,14,52,21,53,22,42,49,50,66,53,57,61,56,FLAT
17,28,7,35,21,30,53,22,14,20,6,17,22,28,23,31,66,41,59,39,56,69,56,83,FLAT
-13,6,16,22,35,21,30,53,17,-4,9,-13,31,16,15,4,39,24,32,18,83,37,68,26,FLAT
31,34,6,40,22,35,21,30,-13,21,3,31,4,17,12,18,18,37,18,35,26,45,35,49,FLAT
-110,4,110,114,41,29,22,40,-13,-38,-111,-110,-17,-26,-111,-123,-32,-32,-124,-127,-1,-38,-112,-142,FLAT
-92,12,127,139,114,41,29,22,-110,-75,-100,-92,-123,-113,-211,-202,-127,-101,-211,-215,-142,-107,-224,-219,FLAT
-14,45,18,63,139,114,41,29,-92,-123,-47,-14,-202,-198,-147,-106,-215,-236,-258,-216,-219,-224,-258,-229,FLAT
-29,18,29,47,63,139,114,41,-14,-18,-2,-29,-106,-141,-49,-43,-216,-216,-149,-135,-229,-254,-260,-245,FLAT
3,6,46,52,47,63,139,114,-29,20,15,3,-43,2,13,-26,-135,-121,-34,-40,-245,-196,-134,-132,FLAT
-76,9,82,91,52,47,63,139,3,-40,-79,-76,-26,-20,-64,-73,-40,-38,-66,-102,-132,-161,-113,-116,FLAT
-21,15,41,56,91,52,47,63,-76,-62,-27,-21,-73,-102,-106,-97,-102,-82,-91,-94,-116,-100,-93,-123,FLAT
-1,25,31,56,56,91,52,47,-21,-11,-11,-1,-97,-73,-38,-22,-94,-113,-117,-98,-123,-93,-102,-95,FLAT
-55,47,55,102,56,56,91,52,-1,-31,-77,-55,-22,-42,-88,-56,-98,-104,-115,-77,-95,-144,-194,-153,FLAT
32,55,6,61,117,102,56,56,94,33,89,32,39,77,118,126,38,46,41,71,17,35,30,70,FLAT
-7,30,23,53,61,117,102,56,32,10,18,-7,126,43,107,25,71,87,136,119,70,56,59,64,FLAT
-5,27,27,54,53,61,117,102,-7,-1,-2,-5,25,9,16,-12,119,42,105,20,64,86,134,114,FLAT
26,28,24,52,54,53,61,117,-5,23,25,26,-12,22,23,21,20,32,41,14,114,65,130,46,FLAT
-9,2,25,27,52,54,53,61,26,-8,17,-9,21,15,42,17,14,14,40,12,46,24,58,5,FLAT
-98,1,104,105,27,52,54,53,-9,-19,-97,-98,17,-27,-80,-107,12,-4,-55,-81,5,-5,-57,-86,FLAT
119,141,18,159,105,27,52,54,-98,33,-21,119,-107,14,-118,21,-81,6,-101,12,-86,29,-76,38,FLAT
-38,50,64,114,159,105,27,52,119,8,53,-38,21,41,32,81,12,22,-65,-17,38,14,-48,-26,FLAT
-8,10,29,39,114,159,105,27,-38,-43,32,-8,81,-35,85,-46,-17,-2,64,73,-26,-21,-33,-25,FLAT
-36,23,36,59,106,39,114,159,102,-4,43,-36,94,73,53,66,56,30,85,58,175,38,138,20,FLAT
110,160,5,165,59,106,39,114,-36,79,-27,110,66,75,16,74,58,152,26,176,20,109,58,168,FLAT
-82,0,97,97,165,59,106,39,110,10,78,-82,74,89,51,28,176,85,94,-8,168,162,104,94,FLAT
26,45,11,56,97,165,59,106,-82,-60,-19,26,28,-50,59,-56,-8,29,32,54,94,25,75,18,FLAT
16,68,5,73,56,97,165,59,26,10,-7,16,-56,-50,-26,42,54,-40,52,-40,18,39,25,70,FLAT
-22,14,49,63,73,56,97,165,16,22,32,-22,42,32,25,-6,-40,-28,6,20,70,-18,84,-62,FLAT
34,64,30,94,63,73,56,97,-22,15,-16,34,-6,37,16,12,20,47,9,28,-62,-13,-10,54,FLAT
50,75,16,91,94,63,73,56,34,36,39,50,12,51,23,84,28,73,55,62,54,83,48,78,FLAT
36,36,14,50,91,94,63,73,50,34,75,36,84,70,114,86,62,85,98,120,78,107,130,98,FLAT
-13,33,39,72,50,91,94,63,36,12,-10,-13,86,46,65,23,120,82,104,73,98,97,88,107,FLAT
60,65,14,79,72,50,91,94,-13,35,28,60,23,47,18,47,73,81,93,83,107,117,132,133,FLAT
-15,50,47,97,79,72,50,91,60,18,0,-15,47,53,28,45,83,65,18,32,133,99,93,68,FLAT
16,31,67,98,97,79,72,50,-15,36,35,16,45,54,35,1,32,89,63,61,68,101,53,48,FLAT
38,38,166,204,98,97,79,72,16,137,31,38,1,173,66,54,61,191,66,39,48,226,94,99,FLAT
-80,9,81,90,204,98,97,79,38,-165,-51,-80,54,-28,-20,-42,39,8,15,-26,99,26,15,-41,FLAT
3,38,10,48,90,204,98,97,-80,-68,-26,3,-42,-233,-77,-77,-26,-96,-46,-39,-41,-60,-11,-23,FLAT
-31,41,41,82,48,90,204,98,3,0,-34,-31,-77,-68,-60,-28,-39,-233,-111,-108,-23,-96,-80,-70,FLAT
31,80,0,80,82,48,90,204,-31,-10,-8,31,-28,-10,-42,0,-108,-78,-68,3,-70,-243,-119,-77,FLAT
44,143,6,149,48,80,82,48,43,50,-51,44,74,93,24,87,43,83,16,118,46,83,-18,87,FLAT
-6,2,50,52,149,48,80,82,44,38,135,-6,87,88,84,38,118,131,159,81,87,121,151,112,FLAT
14,43,19,62,52,149,48,80,-6,-17,-27,14,38,21,108,8,81,71,57,52,112,114,132,95,FLAT
-6,20,39,59,58,62,52,149,-25,8,7,-6,-11,-11,-8,-31,-17,-28,-35,-17,27,10,100,-23,FLAT
-6,4,39,43,59,58,62,52,-6,-6,10,-6,-31,2,17,-12,-17,-17,2,-37,-23,-34,-25,-23,FLAT
-21,23,29,52,43,59,58,62,-6,-31,-40,-21,-12,-37,-30,-27,-37,-29,-23,-33,-23,-48,-38,-58,FLAT
10,17,12,29,52,43,59,58,-21,-7,16,10,-27,-38,-24,-11,-33,-44,-14,-17,-58,-36,-7,-23,FLAT
-22,2,25,27,29,52,43,59,10,-9,-7,-22,-11,-16,9,-12,-17,-47,-31,-33,-23,-53,-21,-39,FLAT
-40,0,44,44,27,29,52,43,-22,-21,-38,-40,-12,-30,-45,-62,-33,-37,-29,-52,-39,-68,-69,-73,FLAT
-29,1,32,33,38,23,15,30,17,-15,-10,-29,31,12,2,-12,17,19,1,2,46,19,16,-12,FLAT
-7,3,14,17,33,38,23,15,-29,-25,-9,-7,-12,-40,-19,-36,2,-13,-7,-19,-12,-6,-8,-5,FLAT
8,9,9,18,17,33,38,23,-7,3,2,8,-36,-22,-7,1,-19,-37,-17,-28,-5,-10,-5,-11,FLAT
-3,20,3,23,18,17,33,38,8,-9,-14,-3,1,-6,-12,5,-28,-31,-21,-2,-11,-46,-31,-31,FLAT
-35,2,36,38,23,18,17,33,-3,-2,-17,-35,5,-11,-31,-38,-2,-8,-29,-30,-31,-33,-38,-37,FLAT
-22,7,26,33,38,23,18,17,-35,-32,-27,-22,-38,-34,-44,-57,-30,-43,-58,-60,-37,-40,-56,-52,FLAT
-44,1,45,46,33,38,23,18,-22,-25,-38,-44,-57,-57,-65,-66,-60,-59,-82,-101,-52,-68,-96,-104,FLAT
37,38,0,38,46,33,38,23,-44,-8,0,37,-66,-33,-38,-7,-101,-65,-65,-29,-104,-67,-82,-64,FLAT
-25,5,41,46,38,46,33,38,37,16,8,-25,-7,8,8,12,-29,-17,-30,-32,-64,-49,-57,-54,FLAT
64,72,1,73,68,46,38,46,56,54,49,64,31,80,53,120,68,96,61,95,24,88,61,132,FLAT
37,37,18,55,73,68,46,38,64,54,72,37,120,108,121,101,95,134,125,157,132,150,133,132,FLAT
38,66,0,66,55,73,68,46,37,20,9,38,101,74,81,75,157,128,130,139,132,154,134,195,FLAT
-36,30,36,66,66,55,73,68,38,0,0,-36,75,20,9,2,139,74,81,39,195,128,130,103,FLAT
-72,50,82,132,41,66,66,55,-30,-28,-119,-72,-66,-56,-122,-102,-28,-56,-122,-138,9,-36,-113,-100,FLAT
19,51,27,78,132,41,66,66,-72,-36,18,19,-102,-64,-101,-53,-138,-92,-104,-83,-100,-92,-104,-119,FLAT
-26,31,42,73,78,132,41,66,19,-11,-6,-26,-53,-47,12,-7,-83,-75,-107,-79,-119,-103,-110,-109,FLAT
-22,0,53,53,73,78,132,41,-26,-11,9,-22,-7,-22,3,-48,-79,-58,21,-29,-109,-86,-98,-101,FLAT
-33,8,80,88,53,73,78,132,-22,-6,-41,-33,-48,-17,-32,-55,-29,-28,-38,-81,-101,-64,-20,-62,FLAT
7,35,35,70,88,53,73,78,-33,-38,-20,7,-55,-44,-61,-26,-81,-55,-52,-48,-62,-66,-58,-74,FLAT
46,56,9,65,70,88,53,73,7,20,25,46,-26,-18,5,53,-48,-24,-36,20,-74,-35,-27,-2,FLAT
20,27,9,36,65,70,88,53,46,20,49,20,53,40,74,66,20,2,54,73,-2,-4,13,40,FLAT
-6,30,12,42,36,65,70,88,20,-3,-9,-6,66,17,40,14,73,37,65,60,40,-1,45,67,FLAT
-30,19,33,52,42,36,65,70,-6,-9,-19,-30,14,-12,-28,-36,60,8,21,-16,67,28,46,30,FLAT
11,41,7,48,52,42,36,65,-30,-15,-11,11,-36,-24,-30,-19,-16,-27,-39,-25,30,-7,10,-5,FLAT
5,16,15,31,48,52,42,36,11,13,30,5,-19,-2,19,16,-25,-11,0,-14,-5,-14,-9,-20,FLAT
21,23,15,38,31,48,52,42,5,21,14,21,16,34,44,26,-14,19,33,37,-20,10,14,7,FLAT
-63,4,79,83,38,31,48,52,21,1,-44,-63,26,22,-30,-42,37,35,0,-37,7,20,-11,-26,FLAT
-49,8,70,78,83,38,31,48,-63,-58,-53,-49,-42,-57,-97,-112,-37,-36,-83,-91,-26,-23,-53,-86,FLAT
47,61,6,67,78,83,38,31,-49,-17,-6,47,-112,-75,-59,-2,-91,-74,-103,-65,-86,-53,-89,-44,FLAT
44,49,5,54,67,78,83,38,47,43,56,44,-2,26,50,91,-65,-32,-3,42,-44,-31,-47,-21,FLAT
-18,5,38,43,54,67,78,83,44,15,26,-18,91,58,82,26,42,41,76,73,-21,-17,23,24,FLAT
7,54,9,63,43,54,67,78,-18,-22,-42,7,26,-7,-16,-11,73,36,40,33,24,19,34,80,FLAT
-6,25,17,42,63,43,54,67,7,2,23,-6,-11,-20,-19,1,33,-5,7,-17,80,38,63,27,FLAT
0,20,10,30,42,63,43,54,-6,-7,5,0,1,-5,28,-6,-17,-27,-14,1,27,-12,12,-17,FLAT
23,27,3,30,30,42,63,43,0,16,16,23,-6,9,21,23,1,11,44,17,-17,-11,2,24,FLAT
-24,23,27,50,30,30,42,63,23,0,-20,-24,23,16,-4,-1,17,9,1,-1,24,11,24,-7,FLAT
10,18,10,28,50,30,30,42,-24,-7,15,10,-1,-7,-5,-14,-1,9,11,9,-7,2,16,9,FLAT
-10,10,26,36,28,50,30,30,10,6,-2,-10,-14,-1,13,0,9,-1,-7,-24,9,15,9,-1,FLAT
15,33,3,36,36,28,50,30,-10,-8,-8,15,0,-2,-10,5,-24,-9,5,15,-1,-9,-15,-9,FLAT
20,31,4,35,36,36,28,50,15,21,22,20,5,13,14,35,15,19,12,25,-9,12,27,35,FLAT
43,56,9,65,35,36,36,28,20,48,18,43,35,69,40,63,25,61,32,78,35,67,30,68,FLAT
-59,19,72,91,65,35,36,36,43,4,-22,-59,63,52,-4,-16,78,73,18,4,68,65,10,19,FLAT
16,35,9,44,91,65,35,36,-59,-47,0,16,-16,-43,-22,-43,4,5,-4,0,19,26,18,20,FLAT
-7,31,16,47,44,91,65,35,16,0,-3,-7,-43,-47,-3,9,0,-43,-25,-50,20,5,-7,-7,FLAT
-15,23,16,39,47,44,91,65,-7,-15,-7,-15,9,-15,-10,-22,-50,-62,-10,-6,-7,-58,-32,-65,FLAT
5,35,0,35,39,47,44,91,-15,-11,-7,5,-22,-26,-14,-10,-6,-26,-17,-17,-65,-73,-17,-1,FLAT
9,23,6,29,35,39,47,44,5,15,21,9,-10,4,14,14,-17,-11,7,-1,-1,-11,4,-8,FLAT
-48,6,54,60,40,29,35,39,-29,-25,-45,-48,-20,-29,-60,-77,-15,-14,-39,-68,-30,-25,-46,-63,FLAT
-7,6,27,33,60,40,29,35,-48,-34,-7,-7,-77,-59,-52,-55,-68,-63,-67,-84,-63,-48,-46,-75,FLAT
17,17,14,31,33,60,40,29,-7,4,6,17,-55,-30,-1,10,-84,-55,-46,-38,-75,-59,-61,-67,FLAT
24,34,0,34,31,33,60,40,17,10,7,24,10,14,13,41,-38,-20,6,34,-67,-45,-39,-14,FLAT
-11,4,17,21,34,31,33,60,24,6,19,-11,41,16,26,13,34,20,32,30,-14,-14,25,23,FLAT
-8,9,17,26,21,34,31,33,-11,-8,-13,-8,13,-2,6,-19,30,8,13,5,23,12,19,22,FLAT
-9,9,16,25,26,21,34,31,-8,-10,-9,-9,-19,-18,-22,-17,5,-12,-3,-28,22,-2,4,-4,FLAT
-12,3,17,20,26,42,17,26,21,0,6,-12,0,-4,18,9,4,2,-1,-12,24,8,14,-8,FLAT
-1,13,3,16,20,26,42,17,-12,-15,-11,-1,9,-15,-5,-13,-12,-19,7,8,-8,-13,-12,-13,FLAT
-8,11,10,21,16,20,26,42,-1,-1,-6,-8,-13,-16,-17,-9,8,-16,-11,-21,-13,-20,1,0,FLAT
3,15,0,15,21,16,20,26,-8,-7,-1,3,-9,-8,-7,-5,-21,-23,-18,-6,0,-23,-12,-18,FLAT
-10,6,11,17,15,21,16,20,3,1,-1,-10,-5,-6,-2,-7,-6,-7,-8,-15,-18,-22,-19,-16,FLAT
-67,14,68,82,17,15,21,16,-10,-10,-75,-67,-7,-9,-76,-77,-15,-16,-77,-74,-16,-17,-83,-82,FLAT
41,47,1,48,61,82,17,15,48,37,50,41,-19,22,56,89,-29,12,-19,22,-26,13,-20,12,FLAT
35,40,27,67,48,61,82,17,41,61,42,35,89,98,92,76,22,83,98,124,12,73,23,57,FLAT
-15,24,47,71,67,48,61,82,35,5,1,-15,76,66,43,20,124,103,93,61,57,88,99,109,FLAT
-55,13,61,74,71,67,48,61,-15,-41,-44,-55,20,-36,-43,-70,61,25,-1,-35,109,62,49,6,FLAT
65,96,8,104,74,71,67,48,-55,12,-18,65,-70,-29,-62,10,-35,-24,-61,-5,6,37,-19,30,FLAT
193,193,16,209,81,104,74,71,16,145,17,193,81,217,112,209,26,229,94,274,11,188,50,219,FLAT
-25,12,86,98,209,81,104,74,193,45,156,-25,209,190,173,168,274,262,268,184,219,274,250,249,FLAT
-103,12,103,115,64,98,209,81,-23,-48,-99,-103,-48,-109,-126,-126,145,-64,30,-151,161,81,47,42,FLAT
-97,108,99,207,115,64,98,209,-103,-101,-193,-97,-126,-149,-292,-200,-151,-210,-319,-223,42,-165,-163,-248,FLAT
113,151,8,159,97,207,115,64,40,88,26,113,-57,62,110,153,-160,-39,-83,56,-183,-87,-182,-47,FLAT
-43,7,61,68,159,97,207,115,113,10,101,-43,153,98,127,70,56,72,211,110,-47,-29,18,13,FLAT
-69,3,117,120,68,159,97,207,-43,-13,-65,-69,70,-3,36,-112,110,85,62,1,13,59,146,41,FLAT
84,141,19,160,120,68,159,97,-69,-14,-54,84,-112,-27,-119,15,1,-17,-18,-28,41,71,8,85,FLAT
36,61,18,79,160,120,68,159,84,35,116,36,15,21,62,120,-28,8,-3,51,85,18,98,8,FLAT
11,46,15,61,79,160,120,68,36,8,26,11,120,43,142,47,51,29,88,131,8,16,23,62,FLAT
-25,10,50,60,96,61,79,160,-66,-47,-11,-25,-55,-56,-55,-91,-19,-48,-29,-80,65,-13,87,-44,FLAT
-22,13,48,61,60,96,61,79,-25,-24,-25,-22,-91,-71,-36,-47,-80,-80,-80,-113,-44,-72,-54,-102,FLAT
-48,8,49,57,61,60,96,61,-22,-47,-43,-48,-47,-71,-68,-70,-113,-118,-79,-95,-102,-127,-123,-161,FLAT
13,13,19,32,57,61,60,96,-48,-17,8,13,-70,-64,-35,-35,-95,-88,-60,-57,-161,-135,-71,-82,FLAT
5,18,24,42,32,57,61,60,13,10,0,5,-35,-7,8,18,-57,-54,-35,-30,-82,-78,-60,-52,FLAT
20,64,3,67,42,32,57,61,5,-1,-26,20,18,9,-26,25,-30,-8,-18,38,-52,-55,-61,-10,FLAT
-28,3,32,35,67,42,32,57,20,1,33,-28,25,0,7,-8,38,10,7,-3,-10,-7,15,10,FLAT
-1,35,14,49,35,67,42,32,-28,-19,-33,-1,-8,-18,0,-29,-3,-19,-26,-9,10,-9,-26,-4,FLAT
109,120,3,123,99,49,35,67,85,98,74,109,84,183,109,194,56,164,76,193,76,165,109,165,FLAT
-43,17,78,95,123,99,49,35,109,32,60,-43,194,130,134,66,193,215,169,151,165,196,136,150,FLAT
21,37,36,73,95,123,99,49,-43,-21,1,21,66,11,61,-22,151,109,135,87,150,194,170,172,FLAT
-8,2,60,62,73,95,123,99,21,16,27,-8,-22,-5,28,13,87,27,88,-30,172,125,162,79,FLAT
14,62,21,83,90,62,73,95,-50,-53,-46,14,-58,-75,-96,-36,-37,-59,-69,-44,-80,-80,-68,-23,FLAT
-59,39,92,131,83,90,62,73,14,12,-36,-59,-36,-41,-82,-45,-44,-63,-132,-95,-23,-47,-105,-103,FLAT
-53,25,101,126,131,83,90,62,-59,-44,-39,-53,-45,-32,-75,-112,-95,-85,-121,-98,-103,-107,-171,-148,FLAT
-77,27,102,129,126,131,83,90,-53,-76,-79,-77,-112,-120,-118,-130,-98,-108,-154,-189,-148,-161,-200,-175,FLAT
9,70,5,75,129,126,131,83,-77,-88,-34,9,-130,-164,-113,-68,-189,-208,-152,-121,-175,-196,-188,-180,FLAT
-1,55,12,67,75,129,126,131,9,6,14,-1,-68,-82,-20,8,-121,-158,-99,-69,-180,-202,-138,-122,FLAT
0,11,35,46,67,75,129,126,-1,23,44,0,8,29,58,-1,-69,-59,24,8,-122,-135,-55,-69,FLAT
-73,13,102,115,46,67,75,129,0,-6,-75,-73,-1,17,-31,-73,8,23,-17,-74,-69,-65,-51,-65,FLAT
7,23,25,48,115,46,67,75,-73,-70,-3,7,-73,-76,-78,-66,-74,-53,-34,-66,-65,-47,-20,-67,FLAT
-46,14,46,60,48,115,46,67,7,-25,-37,-46,-66,-95,-40,-39,-66,-101,-115,-112,-67,-78,-71,-112,FLAT
16,36,10,46,60,48,115,46,-46,-20,-6,16,-39,-45,-43,-30,-112,-115,-46,-23,-112,-121,-121,-96,FLAT
-12,8,21,29,46,60,48,115,16,-1,16,-12,-30,-21,10,4,-23,-46,-27,-42,-96,-116,-30,-35,FLAT
-21,19,42,61,29,46,60,48,-12,0,-32,-21,4,-1,-16,-33,-42,-21,-22,-17,-35,-46,-59,-63,FLAT
13,32,6,38,61,29,46,60,-21,-23,0,13,-33,-23,-32,-8,-17,-24,-16,-20,-63,-44,-22,-4,FLAT
-21,5,39,44,38,61,29,46,13,12,6,-21,-8,-11,6,-8,-20,-11,-26,-29,-4,-12,-10,-41,FLAT
-10,9,19,28,44,38,61,29,-21,-30,-14,-10,-8,-18,-8,-31,-29,-41,-8,-18,-41,-41,-40,-39,FLAT
9,17,3,20,28,44,38,61,-10,-7,1,9,-31,-37,-13,-1,-18,-25,-7,-22,-39,-48,-7,-9,FLAT
-51,5,54,59,30,10,38,27,19,-1,-30,-51,14,16,-33,-32,-18,-15,-36,-37,-31,-29,-61,-69,FLAT
-35,22,46,68,59,30,10,38,-51,-43,-52,-35,-32,-44,-82,-86,-37,-27,-85,-67,-69,-58,-88,-72,FLAT
-25,4,29,33,68,59,30,10,-35,-42,-7,-25,-86,-85,-59,-60,-67,-86,-89,-111,-72,-69,-92,-92,FLAT
19,24,17,41,33,68,59,30,-25,7,-1,19,-60,-35,-8,-6,-111,-78,-60,-41,-92,-79,-90,-92,FLAT
31,47,3,50,87,41,33,68,70,29,66,31,89,87,78,101,64,94,77,120,29,52,70,95,FLAT
-19,16,25,41,50,87,41,33,31,3,12,-19,101,32,78,12,120,90,90,82,95,97,89,101,FLAT
14,15,7,22,41,50,87,41,-19,-4,15,14,12,-1,27,-5,82,28,93,26,101,86,105,96,FLAT
97,133,9,142,22,41,50,87,14,99,-21,97,-5,95,-6,111,26,98,6,92,96,127,72,123,FLAT
34,57,45,102,142,22,41,50,97,70,110,34,111,169,89,131,92,165,104,145,123,168,116,126,FLAT
71,72,18,90,102,142,22,41,34,44,56,71,131,114,166,105,145,213,145,202,126,209,160,216,FLAT
-23,21,38,59,90,102,142,22,71,-3,28,-23,105,41,84,48,202,111,194,82,216,210,173,179,FLAT
37,40,20,60,59,90,102,142,-23,19,18,37,48,16,46,14,82,60,102,85,179,130,212,119,FLAT
-78,25,78,103,60,59,90,102,37,-20,-63,-78,14,-1,-45,-41,85,-4,-17,-64,119,40,39,7,FLAT
83,90,77,167,103,60,59,90,-78,82,18,83,-41,62,-45,5,-64,81,-27,42,7,78,1,19,FLAT
-68,35,78,113,92,167,103,60,-54,-50,-71,-68,29,-121,-67,-122,-49,-39,-49,-39,-12,-59,-112,-117,FLAT
-21,3,73,76,113,92,167,103,-68,-26,11,-21,-122,-76,-60,-89,-39,-147,-56,-143,-117,-65,-38,-60,FLAT
-8,56,41,97,76,113,92,167,-21,-40,-61,-8,-89,-66,-50,-29,-143,-116,-121,-97,-60,-187,-117,-151,FLAT
0,73,1,74,97,76,113,92,-8,-40,-17,0,-29,-80,-78,-8,-97,-106,-67,-29,-151,-156,-138,-97,FLAT
30,71,15,86,137,74,97,76,114,29,80,30,114,158,146,144,106,118,129,144,85,78,68,136,FLAT
-52,13,56,69,86,137,74,97,30,-11,6,-52,144,18,86,-22,144,147,152,92,136,107,135,92,FLAT
40,48,23,71,69,86,137,74,-52,7,5,40,-22,-4,11,-12,92,25,91,18,92,154,157,132,FLAT
-44,10,64,74,71,69,86,137,40,-3,-6,-44,-12,4,-1,-4,18,-7,5,-56,132,22,85,-26,FLAT
79,82,0,82,74,71,69,86,-44,15,7,79,-4,12,1,35,-56,19,6,75,-26,8,12,23,FLAT
175,182,12,194,82,74,71,69,79,187,75,175,35,202,82,254,75,199,76,210,23,206,81,250,FLAT
-12,23,44,67,194,82,74,71,175,20,147,-12,254,207,222,163,210,222,229,242,250,219,223,198,FLAT
11,23,27,50,67,194,82,74,-12,-6,11,11,163,14,158,-1,242,201,233,174,198,216,240,253,FLAT
5,41,14,55,50,67,194,82,11,-8,-13,5,-1,-14,-2,16,174,6,145,4,253,193,220,179,FLAT
70,108,7,115,55,50,67,194,5,63,3,70,16,55,-10,75,4,49,1,86,179,69,148,74,FLAT
18,63,17,80,115,55,50,67,70,28,63,18,75,91,66,88,86,83,53,93,74,77,64,104,FLAT
-9,39,23,62,80,115,55,50,18,-3,15,-9,88,25,78,9,93,88,81,79,104,80,68,84,FLAT
17,58,37,95,62,80,115,55,-9,31,-2,17,9,28,13,8,79,56,76,26,84,119,79,96,FLAT
-100,113,118,231,364,95,62,80,-173,-158,-25,-100,-156,-192,-328,-273,-165,-161,-330,-256,-147,-164,-315,-265,FLAT
-39,29,150,179,115,231,364,95,42,85,21,-39,-58,35,87,3,-231,-123,62,-97,-214,-157,-241,-270,FLAT
161,161,18,179,179,115,231,364,-39,29,29,161,3,114,50,122,-97,64,116,164,-270,-94,91,64,FLAT
71,146,24,170,124,179,179,115,-95,-17,-63,71,66,-18,-9,-24,27,11,20,137,69,96,41,98,FLAT
-276,98,279,377,170,124,179,179,71,-21,-228,-276,-24,-38,-291,-205,137,-39,-237,-300,98,-10,-208,-139,FLAT
-110,29,156,185,377,170,124,179,-276,-233,-41,-110,-205,-254,-269,-386,-300,-271,-332,-315,-139,-272,-278,-410,FLAT
-53,63,78,141,185,377,170,124,-110,-131,-87,-53,-386,-364,-128,-163,-315,-385,-356,-439,-410,-402,-419,-368,FLAT
-14,34,38,72,369,141,185,377,284,-41,256,-14,231,230,299,270,121,99,212,217,-155,-134,171,107,FLAT
-63,16,90,106,72,369,141,185,-14,-11,-45,-63,270,-52,211,-77,217,219,254,207,107,88,167,154,FLAT
83,105,95,200,106,72,369,141,-63,88,-6,83,-77,77,-51,20,207,36,205,6,154,307,248,290,FLAT
36,73,11,84,200,106,72,369,83,-48,68,36,20,40,62,119,6,29,17,56,290,-12,273,42,FLAT
53,54,84,138,84,200,106,72,36,126,72,53,119,78,140,89,56,166,134,172,42,155,89,109,FLAT
-61,6,67,73,138,84,200,106,53,-78,-13,-61,89,48,59,-8,172,0,127,28,109,88,121,111,FLAT
26,27,28,55,73,138,84,200,-61,-13,5,26,-8,-91,-8,-35,28,35,64,18,111,-13,132,54,FLAT
-15,18,45,63,55,73,138,84,26,2,-6,-15,-35,-11,-1,11,18,-89,-14,-50,54,37,58,3,FLAT
38,41,6,47,63,55,73,138,-15,-1,15,38,11,1,9,23,-50,-12,14,49,3,-90,1,-12,FLAT
28,33,11,44,47,63,55,73,38,33,36,28,23,32,51,66,49,34,45,51,-12,21,50,77,FLAT
-3,27,33,60,44,47,63,55,28,19,3,-3,66,52,39,25,51,51,54,63,77,53,48,48,FLAT
30,64,1,65,60,44,47,63,-3,-2,-7,30,25,17,-4,27,63,50,32,55,48,49,47,93,FLAT
8,14,9,23,35,27,55,18,-34,-17,-5,8,-35,-28,-24,-26,10,-26,6,-27,17,23,18,18,FLAT
7,30,1,31,23,35,27,55,8,-1,-9,7,-26,-18,-14,15,-27,-29,-33,-19,18,-27,-3,-20,FLAT
37,41,0,41,31,23,35,27,7,36,26,37,15,35,17,44,-19,18,12,52,-20,7,-7,18,FLAT
24,32,2,34,41,31,23,35,37,26,33,24,44,62,59,61,52,61,50,68,18,44,45,76,FLAT
-36,0,41,41,34,41,31,23,24,3,-4,-36,61,29,29,-12,68,65,55,25,76,64,46,32,FLAT
38,44,15,59,41,34,41,31,-36,12,-6,38,-12,15,-10,2,25,41,23,26,32,77,49,63,FLAT
-24,7,31,38,59,41,34,41,38,-8,13,-24,2,4,7,14,26,7,3,-22,63,33,36,2,FLAT
1,15,11,26,38,59,41,34,-24,-19,-7,1,14,-27,6,-23,-22,-15,0,15,2,-12,-4,-21,FLAT
-51,11,64,75,26,38,59,41,1,2,-47,-51,-23,-17,-54,-50,15,-25,-41,-74,-21,-13,-47,-36,FLAT
101,104,28,132,75,26,38,59,-51,65,8,101,-50,67,-39,50,-74,48,-46,51,-36,40,-33,27,FLAT
8,14,21,35,73,132,75,26,-56,-29,9,8,45,-55,42,-48,-6,10,50,53,-5,12,3,2,FLAT
-98,19,107,126,35,73,132,75,8,-12,-103,-98,-48,-41,-94,-90,53,-67,-61,-146,2,-2,-53,-45,FLAT
25,62,56,118,126,35,73,132,-98,-26,-18,25,-90,-38,-121,-73,-146,-67,-112,-65,-45,-93,-79,-121,FLAT
-38,43,71,114,118,126,35,73,25,-23,-19,-38,-73,-49,-37,-13,-65,-61,-140,-111,-121,-90,-131,-103,FLAT
4,17,58,75,114,118,126,35,-38,-9,30,4,-13,-32,11,-34,-111,-58,-7,-9,-103,-70,-110,-107,FLAT
-60,45,84,129,75,114,118,126,4,-34,-88,-60,-34,-43,-58,-56,-9,-66,-77,-94,-107,-92,-95,-69,FLAT
-46,38,47,85,129,75,114,118,-60,-83,-39,-46,-56,-117,-127,-106,-94,-126,-97,-102,-69,-149,-116,-140,FLAT
-23,2,50,52,139,85,129,75,67,1,88,-23,21,47,80,44,-39,-36,41,-2,-35,-70,-47,-62,FLAT
21,46,21,67,52,139,85,129,-23,-8,-23,21,44,-7,65,-2,-2,39,57,65,-62,-44,18,19,FLAT
32,33,40,73,67,52,139,85,21,51,45,32,-2,43,22,53,65,44,110,30,19,90,102,97,FLAT
-74,6,81,87,73,67,52,139,32,-33,-47,-74,53,18,-2,-42,30,10,-25,-21,97,11,63,-44,FLAT
112,150,39,189,87,73,67,52,-74,70,-32,112,-42,37,-79,38,-21,88,-34,70,-44,80,-57,91,FLAT
-45,8,74,82,189,87,73,67,112,-10,97,-45,38,60,65,67,70,27,18,-7,91,78,63,25,FLAT
13,32,8,40,82,189,87,73,-45,-53,-11,13,67,-63,86,-32,-7,7,54,80,25,-26,7,6,FLAT
12,51,2,53,40,82,189,87,13,6,-7,12,-32,-47,-18,25,80,-57,79,-20,6,13,47,92,FLAT
114,117,21,138,53,40,82,189,12,133,48,114,25,139,41,126,-20,86,30,139,92,76,127,94,FLAT
-21,12,33,45,138,53,40,82,114,-9,84,-21,126,124,132,93,139,130,125,105,94,77,114,118,FLAT
-8,27,20,47,45,138,53,40,-21,-21,-23,-8,93,-30,61,-29,105,103,109,85,118,109,102,97,FLAT
-3,25,19,44,47,45,138,53,-8,-4,-1,-3,-29,-25,-24,-11,85,-34,60,-32,97,99,108,82,FLAT
20,22,40,62,44,47,45,138,-3,41,23,20,-11,37,22,17,-32,16,-1,9,82,7,83,-12,FLAT
-56,0,91,91,62,44,47,45,20,-5,-34,-56,17,36,-11,-36,9,32,-12,-39,-12,11,-35,-47,FLAT
-23,3,76,79,91,62,44,47,-56,-38,-26,-23,-36,-43,-60,-79,-39,-2,-37,-59,-47,-6,-38,-62,FLAT
89,195,0,195,79,91,62,44,-23,13,-103,89,-79,-25,-129,66,-59,-30,-163,10,-62,11,-140,30,FLAT
162,206,212,418,195,79,91,62,89,374,151,162,66,387,48,251,10,349,22,228,30,344,-12,172,FLAT
12,77,135,212,418,195,79,91,162,-65,141,12,251,309,292,174,228,322,189,263,172,284,163,240,FLAT
-30,132,45,177,212,418,195,79,12,-120,-85,-30,174,-185,56,-18,263,189,207,144,240,202,104,233,FLAT
-8,34,59,93,177,212,418,195,-30,6,90,-8,-18,-114,5,-38,144,-179,146,-26,233,195,297,136,FLAT
35,36,88,124,118,93,177,212,49,80,74,35,41,113,82,84,11,119,172,76,23,-1,87,46,FLAT
34,98,36,134,124,118,93,177,35,-18,-28,34,84,62,46,69,76,95,54,118,46,101,144,110,FLAT
98,127,7,134,134,124,118,93,34,69,69,98,69,51,41,132,118,131,115,167,110,164,123,216,FLAT
188,203,3,206,134,134,124,118,98,184,112,188,132,253,181,286,167,235,153,320,216,315,227,355,FLAT
7,60,52,112,206,134,134,124,188,56,150,7,286,240,262,195,320,309,331,293,355,291,303,327,FLAT
5,47,32,79,112,206,134,134,7,-15,18,5,195,41,168,12,293,225,280,200,327,294,349,298,FLAT
-3,28,29,57,79,112,206,134,5,-6,16,-3,12,-21,34,2,200,35,184,9,298,219,296,197,FLAT
78,78,9,87,57,79,112,206,-3,58,28,78,2,52,44,75,9,37,62,80,197,93,212,87,FLAT
62,79,4,83,87,57,79,112,78,57,61,62,75,115,89,140,80,109,105,137,87,94,123,142,FLAT
38,38,11,49,83,87,57,79,62,45,79,38,140,102,140,100,137,160,168,178,142,154,184,175,FLAT
8,28,7,35,49,83,87,57,38,4,18,8,100,49,97,46,178,106,158,108,175,164,186,186,FLAT
16,36,3,39,35,49,83,87,8,12,8,16,46,16,26,24,108,61,105,62,186,118,166,124,FLAT
26,47,9,56,39,35,49,83,16,32,15,26,24,44,23,42,62,48,41,50,124,93,120,88,FLAT
-15,40,26,66,56,39,35,49,26,2,-8,-15,42,34,7,11,50,46,15,27,88,50,33,35,FLAT
13,19,16,35,66,56,39,35,-15,3,34,13,11,5,26,-2,27,37,41,24,35,49,49,40,FLAT
-15,7,52,59,54,35,66,56,-26,-4,-9,-15,-13,-5,-29,-41,-28,-2,5,-28,-2,0,-3,-43,FLAT
1,16,5,21,35,54,48,49,7,0,14,1,-19,-37,-4,8,-48,-60,-33,-18,-15,-49,-21,-47,FLAT
14,30,0,30,21,35,54,48,1,9,0,14,8,9,14,15,-18,-28,-4,22,-47,-51,-33,-4,FLAT
-1,8,7,15,30,21,35,54,14,6,21,-1,15,15,21,13,22,15,35,14,-4,-22,17,21,FLAT
-6,6,15,21,15,30,21,35,-1,2,-4,-6,13,8,17,-7,14,17,17,7,21,17,31,8,FLAT
-36,3,37,40,21,15,30,21,-6,-14,-33,-36,-7,-12,-37,-42,7,-6,-16,-43,8,3,-16,-29,FLAT
8,10,25,35,40,21,15,30,-36,-4,1,8,-42,-18,-32,-28,-43,-16,-36,-34,-29,-10,-15,-35,FLAT
-16,1,27,28,35,40,21,15,8,-14,-7,-16,-28,-18,-6,-8,-34,-32,-39,-44,-35,-30,-43,-50,FLAT
1,26,20,46,28,35,40,21,-16,-6,-24,1,-8,-20,-31,-15,-44,-24,-30,-7,-50,-38,-63,-43,FLAT
-61,1,89,90,46,28,35,40,1,8,-36,-61,-15,2,-60,-60,-7,-12,-67,-76,-43,-16,-66,-68,FLAT
34,46,45,91,90,46,28,35,-61,-10,-11,34,-60,-2,-47,-27,-76,-8,-71,-26,-68,-22,-78,-42,FLAT
-24,13,31,44,60,91,90,46,31,5,21,-24,65,-7,40,7,4,-17,29,41,5,-9,-7,-20,FLAT
2,12,43,55,44,60,91,90,-24,14,3,2,7,19,24,-22,41,7,43,9,-20,-3,32,43,FLAT
90,92,60,152,55,44,60,91,2,107,10,90,-22,121,13,92,9,126,34,68,43,114,53,99,FLAT
-93,9,114,123,152,55,44,60,90,-39,-10,-93,92,68,0,-3,68,82,3,-1,99,87,24,-25,FLAT
3,4,47,51,123,152,55,44,-93,-64,8,3,-3,-103,-2,-90,-1,4,8,0,-25,18,11,2,FLAT
41,61,9,70,51,123,152,55,3,3,-16,41,-90,-61,-8,44,0,-100,-18,-49,2,7,-8,41,FLAT
46,63,13,76,70,51,123,152,41,50,44,46,44,53,28,87,-49,-11,36,90,41,-50,26,-3,FLAT
-9,45,16,61,76,70,51,123,46,-6,9,-9,87,44,53,37,90,47,37,78,-3,-17,45,81,FLAT
25,71,0,71,61,76,70,51,-9,9,-1,25,37,3,8,16,78,53,52,62,81,56,36,103,FLAT
41,55,9,64,71,61,76,70,25,50,57,41,16,59,56,66,62,53,65,57,103,103,109,103,FLAT
25,49,11,60,64,71,61,76,41,27,31,25,66,77,88,66,57,86,87,91,103,80,96,82,FLAT
45,76,15,91,60,64,71,61,25,49,18,45,66,76,49,70,91,126,106,111,82,135,105,136,FLAT
-3,13,35,48,101,43,91,60,-82,-57,-4,-3,-99,-69,-74,-85,-54,-82,-39,-102,-29,-33,-21,-57,FLAT
-19,9,35,44,48,101,43,91,-3,-19,-15,-19,-85,-76,-19,-22,-102,-88,-89,-104,-57,-101,-54,-121,FLAT
-19,33,25,58,44,48,101,43,-19,-29,-43,-19,-22,-48,-58,-38,-104,-105,-62,-41,-121,-117,-132,-123,FLAT
14,35,0,35,58,44,48,101,-19,-11,12,14,-38,-40,-31,-5,-41,-59,-46,-24,-123,-116,-50,-27,FLAT
-6,6,36,42,35,58,44,48,14,30,23,-6,-5,19,35,8,-24,-10,-8,-11,-27,-29,-23,-30,FLAT
-8,45,18,63,42,35,58,44,-6,-26,-47,-8,8,4,-24,-14,-11,-7,-12,0,-30,-36,-55,-19,FLAT
20,32,8,40,63,42,35,58,-8,10,33,20,-14,-16,-14,12,0,14,9,6,-19,3,21,20,FLAT
-59,2,68,70,40,63,42,35,20,1,-29,-59,12,11,4,-39,6,-15,-43,-47,20,15,-20,-53,FLAT
6,8,36,44,70,40,63,42,-59,-26,0,6,-39,-25,-29,-53,-47,-15,4,-33,-53,-41,-43,-41,FLAT
-26,37,46,83,44,70,40,63,6,-16,-55,-26,-53,-42,-55,-20,-33,-41,-84,-79,-41,-31,-51,-59,FLAT
-41,29,41,70,83,44,70,40,-26,-46,-33,-41,-20,-62,-88,-67,-79,-88,-88,-61,-59,-87,-117,-120,FLAT
-9,35,11,46,70,83,44,70,-41,-39,-15,-9,-67,-85,-48,-50,-61,-101,-103,-76,-120,-127,-103,-70,FLAT
55,80,8,88,83,46,70,83,75,55,50,55,66,127,85,130,25,88,70,121,-1,42,37,80,FLAT
-22,43,66,109,88,83,46,70,55,36,15,-22,130,91,65,33,121,163,100,108,80,124,85,99,FLAT
91,100,44,144,109,88,83,46,-22,69,34,91,33,105,49,69,108,160,99,124,99,232,134,199,FLAT
129,133,4,137,144,109,88,83,91,89,96,129,69,158,130,220,124,194,145,198,199,249,195,253,FLAT
-51,20,55,75,137,144,109,88,129,0,62,-51,220,89,158,78,198,158,192,169,253,194,207,147,FLAT
-38,43,43,86,75,137,144,109,-51,-50,-61,-38,78,-50,1,-89,169,39,97,40,147,108,131,131,FLAT
39,51,53,104,86,75,137,144,-38,49,31,39,-89,-1,-30,1,40,-1,32,-50,131,88,128,79,FLAT
62,62,17,79,104,86,75,137,39,26,51,62,1,75,82,101,-50,25,21,63,79,25,83,12,FLAT
25,40,4,44,79,104,86,75,62,12,47,25,101,38,98,87,63,87,129,126,12,37,68,88,FLAT
33,42,2,44,44,79,104,86,25,31,31,33,87,43,78,58,126,69,129,120,88,118,160,159,FLAT
31,40,30,70,44,44,79,104,33,59,33,31,58,90,64,64,120,102,111,89,159,128,162,151,FLAT
-52,20,59,79,70,44,44,79,31,-23,-32,-52,64,36,1,-21,89,67,32,12,151,79,79,37,FLAT
35,44,8,52,79,70,44,44,-52,-16,11,35,-21,-39,-21,-17,12,20,12,14,37,51,43,47,FLAT
-8,2,38,40,52,79,70,44,35,22,34,-8,-17,6,45,27,14,-17,13,-25,47,42,46,6,FLAT
19,20,20,40,40,52,79,70,-8,1,1,19,27,23,35,11,-25,7,46,46,6,-16,14,-6,FLAT
0,19,7,26,40,40,52,79,19,-13,1,0,11,-12,2,19,46,10,36,11,-6,-6,47,46,FLAT
31,36,2,38,26,40,40,52,0,26,14,31,19,13,15,31,11,14,16,50,46,36,50,42,FLAT
37,41,6,47,38,26,40,40,31,41,32,37,31,67,46,68,50,54,47,68,42,55,48,87,FLAT
-9,11,13,24,47,38,26,40,37,-2,21,-9,68,39,53,28,68,65,67,59,87,52,68,59,FLAT
41,45,3,48,36,32,52,69,-10,20,8,41,-26,9,-7,31,-55,-15,-11,15,-10,-26,-5,-14,FLAT
-6,8,9,17,48,36,32,52,41,0,31,-6,31,20,39,35,15,9,24,25,-14,-15,20,9,FLAT
0,17,12,29,17,48,36,32,-6,3,-9,0,35,3,22,-6,25,23,30,35,9,12,15,25,FLAT
15,25,19,44,29,17,48,36,0,22,7,15,-6,25,-2,15,35,25,29,9,25,45,37,50,FLAT
15,36,2,38,44,29,17,48,15,-2,4,15,15,20,11,30,9,23,2,30,50,23,33,24,FLAT
9,17,10,27,38,44,29,17,15,17,28,9,30,15,32,24,30,37,39,39,24,40,30,39,FLAT
-16,2,38,40,53,27,38,44,-28,-20,-7,-16,-19,-16,-29,-44,-4,1,-1,-35,11,-1,3,-20,FLAT
-92,11,112,123,40,53,27,38,-16,-18,-101,-92,-44,-38,-108,-108,-35,-34,-130,-136,-20,-17,-102,-127,FLAT
89,89,33,122,123,40,53,27,-92,10,11,89,-108,-8,-90,-3,-136,-28,-97,-19,-127,-24,-119,-47,FLAT
74,84,37,121,122,123,40,53,89,78,79,74,-3,88,90,163,-19,70,-11,71,-47,50,-18,55,FLAT
33,65,16,81,78,121,122,123,-53,-8,-11,33,21,-41,-1,-20,110,37,78,54,18,47,89,143,FLAT
-84,8,100,108,81,78,121,122,33,0,-27,-84,-20,-8,-38,-51,54,-41,-28,-104,143,37,51,-30,FLAT
10,44,20,64,108,81,78,121,-84,-70,-26,10,-51,-70,-53,-74,-104,-78,-64,-41,-30,-111,-54,-94,FLAT
-7,26,28,54,64,108,81,78,10,1,11,-7,-74,-69,-15,3,-41,-69,-42,-81,-94,-77,-53,-48,FLAT
-52,7,71,78,54,64,108,81,-7,-9,-33,-52,3,-8,-22,-59,-81,-78,-48,-49,-48,-78,-75,-133,FLAT
26,35,33,68,78,54,64,108,-52,-12,-2,26,-59,-21,-35,-26,-49,-20,-24,-33,-133,-90,-50,-23,FLAT
14,23,18,41,68,78,54,64,26,-1,26,14,-26,-13,24,40,-33,-22,-9,-12,-23,-21,2,-19,FLAT
-55,5,90,95,41,68,78,54,14,17,-37,-55,40,16,-11,-41,-12,4,-13,-15,-19,-5,-46,-67,FLAT
-41,4,67,71,95,41,68,78,-55,-64,-40,-41,-41,-47,-77,-96,-15,-48,-51,-82,-67,-60,-53,-56,FLAT
-32,22,85,107,71,95,41,68,-41,-14,-50,-32,-96,-78,-90,-73,-82,-61,-127,-128,-56,-62,-101,-114,FLAT
40,58,4,62,107,71,95,41,-32,-41,4,40,-73,-55,-46,8,-128,-119,-86,-33,-114,-102,-123,-88,FLAT
21,35,14,49,62,107,71,95,40,31,44,21,8,-10,48,61,-33,-24,-2,29,-88,-88,-42,-12,FLAT
9,20,24,44,49,62,107,71,21,19,24,9,61,50,68,30,29,9,72,70,-12,-5,22,38,FLAT
24,36,19,55,44,49,62,107,9,19,8,24,30,38,32,33,70,69,76,54,38,28,80,94,FLAT
-16,6,31,37,55,44,49,62,24,-4,14,-16,33,15,22,8,54,34,46,17,94,65,90,38,FLAT
13,13,42,55,37,55,44,49,-16,24,6,13,8,20,20,-3,17,39,28,21,38,58,52,30,FLAT
-24,21,27,48,55,37,55,44,13,-39,-32,-24,-3,-15,-26,-11,21,-19,-12,-27,30,0,-4,-3,FLAT
-30,11,33,44,48,55,37,55,-24,-24,-20,-30,-11,-63,-52,-54,-27,-39,-46,-41,-3,-43,-32,-57,FLAT
-26,5,40,45,44,48,55,37,-30,-19,-20,-26,-54,-43,-40,-56,-41,-82,-72,-80,-57,-58,-66,-67,FLAT
-115,3,118,121,45,44,48,55,-26,-37,-113,-115,-56,-56,-133,-141,-80,-80,-153,-171,-67,-119,-185,-195,FLAT
-51,7,58,65,121,45,44,48,-115,-111,-55,-51,-141,-148,-168,-166,-171,-167,-188,-192,-195,-191,-208,-222,FLAT
50,53,15,68,65,121,45,44,-51,7,4,50,-166,-104,-51,-1,-192,-141,-164,-116,-222,-160,-184,-142,FLAT
-44,17,54,71,68,65,121,45,50,-5,-8,-44,-1,2,-4,6,-116,-109,-59,-45,-142,-146,-172,-160,FLAT
-25,19,42,61,71,68,65,121,-44,-37,-27,-25,6,-42,-35,-69,-45,-35,-31,-19,-160,-146,-86,-70,FLAT
-1,48,25,73,61,71,68,65,-25,-18,-30,-1,-69,-55,-57,-26,-19,-60,-65,-70,-70,-53,-61,-20,FLAT
39,63,13,76,73,61,71,68,-1,27,24,39,-26,9,-6,38,-70,-28,-33,13,-20,-33,-41,-31,FLAT
39,65,9,74,76,73,61,71,39,35,37,39,38,62,61,78,13,44,31,77,-31,7,4,52,FLAT
-76,0,117,117,74,76,73,61,39,32,-11,-76,78,67,26,-37,77,94,50,2,52,76,20,1,FLAT
50,70,23,93,117,74,76,73,-76,-44,-20,50,-37,-12,-31,-26,2,23,6,13,1,50,30,52,FLAT
-35,52,41,93,93,117,74,76,50,-17,-17,-35,-26,-61,-37,15,13,-29,-48,-61,52,6,-11,-22,FLAT
64,73,24,97,93,93,117,74,-35,47,43,64,15,30,26,29,-61,-14,6,79,-22,18,-5,3,FLAT
17,42,0,42,97,93,93,117,64,-7,48,17,29,40,91,81,79,23,74,46,3,-21,54,96,FLAT
-19,59,36,95,42,97,93,93,17,17,-36,-19,81,10,12,-2,46,57,55,62,96,40,38,27,FLAT
37,66,4,70,95,42,97,93,-19,5,30,37,-2,22,-6,18,62,15,42,35,27,62,85,99,FLAT
-22,18,35,53,70,95,42,97,37,9,26,-22,18,14,56,15,35,31,20,-4,99,24,68,13,FLAT
-16,22,35,57,53,70,95,42,-22,-16,-20,-16,15,-7,6,-38,-4,-2,36,-1,13,15,0,-20,FLAT
21,55,8,63,57,53,70,95,-16,-6,-12,21,-38,-22,-32,5,-1,-13,-6,-17,-20,-8,24,20,FLAT
17,26,13,39,63,57,53,70,21,22,46,17,5,16,34,38,-17,0,14,22,20,9,40,0,FLAT
11,23,20,43,39,63,57,53,17,18,14,11,38,40,60,28,22,34,48,49,0,18,28,33,FLAT
22,35,0,35,43,39,63,57,11,2,10,22,28,20,24,33,49,42,70,50,33,36,58,71,FLAT
59,64,6,70,35,43,39,63,22,65,30,59,33,67,40,81,50,85,54,92,71,107,100,109,FLAT
29,34,13,47,70,35,43,39,59,36,59,29,81,101,89,88,92,103,99,110,109,121,113,121,FLAT
13,31,24,55,47,70,35,43,29,24,16,13,88,60,75,42,110,125,105,101,121,127,115,123,FLAT
4,18,6,24,55,47,70,35,13,-14,17,4,42,10,33,17,101,46,92,46,123,111,122,105,FLAT
-6,34,6,40,24,55,47,70,4,-6,-22,-6,17,-20,-5,-2,46,4,11,11,105,40,70,40,FLAT
22,25,2,27,46,35,44,35,1,-13,6,22,-21,-7,1,23,-38,-17,0,1,-24,-20,-12,-16,FLAT
26,30,16,46,27,46,35,44,22,40,21,26,23,27,27,48,1,33,22,49,-16,23,21,27,FLAT
1,20,16,36,46,27,46,35,26,1,11,1,48,41,32,27,49,28,38,49,27,34,33,50,FLAT
19,22,0,22,36,46,27,46,1,3,17,19,27,4,28,20,49,44,49,46,50,31,55,68,FLAT
19,23,7,30,22,36,46,27,19,26,18,19,20,29,35,38,46,30,46,39,68,70,67,65,FLAT
-12,19,34,53,51,30,22,36,-29,-8,-10,-12,-10,-14,-37,-41,9,12,-19,-22,10,15,-2,-3,FLAT
-22,32,27,59,53,51,30,22,-12,-29,-35,-22,-41,-37,-45,-34,-22,-43,-72,-63,-3,-17,-54,-44,FLAT
-39,5,49,54,59,53,51,30,-22,-17,-12,-39,-34,-46,-47,-61,-63,-54,-57,-73,-44,-60,-84,-102,FLAT
46,46,18,64,54,59,53,51,-39,15,5,46,-61,-2,-7,7,-73,-31,-42,-15,-102,-39,-52,-27,FLAT
1,3,47,50,64,54,59,53,46,30,44,1,7,45,49,47,-15,28,37,8,-27,-1,2,-14,FLAT
-43,1,51,52,50,64,54,59,1,-39,-41,-43,47,-9,3,-42,8,6,8,4,-14,-11,-4,-35,FLAT
-35,24,80,104,52,50,64,54,-43,-6,-58,-35,-42,-45,-99,-78,4,-15,-55,-77,-35,0,-50,-31,FLAT
20,32,20,52,104,52,50,64,-35,-40,12,20,-78,-46,-46,-15,-77,-85,-87,-58,-31,-55,-43,-57,FLAT
29,41,21,62,52,104,52,50,20,30,20,29,-15,-10,32,49,-58,-16,-26,14,-57,-55,-67,-29,FLAT
-29,25,43,68,62,52,104,52,29,-7,-13,-29,49,23,7,0,14,-17,19,20,-29,-23,-39,-15,FLAT
25,43,6,49,68,62,52,104,-29,-12,7,25,0,-19,-6,-4,20,11,14,25,-15,-29,26,45,FLAT
24,70,3,73,49,68,62,52,25,21,-3,24,-4,9,4,49,25,2,-9,20,45,32,11,49,FLAT
-56,2,65,67,73,49,68,62,24,6,12,-56,49,27,9,-32,20,15,16,-7,49,8,3,-36,FLAT
13,37,20,57,67,73,49,68,-56,-32,-22,13,-32,-26,-10,-43,-7,-5,-13,-19,-36,-17,-6,6,FLAT
-33,7,51,58,57,67,73,49,13,-2,-3,-33,-43,-34,-25,-20,-19,-28,-13,-76,6,-7,-16,-52,FLAT
9,47,3,50,58,57,67,73,-33,-39,-31,9,-20,-41,-34,-24,-76,-73,-56,-11,-52,-67,-44,-67,FLAT
34,57,7,64,50,58,57,67,9,38,24,34,-24,-1,-7,43,-11,-3,-10,10,-67,-35,-32,23,FLAT
-17,35,25,60,64,50,58,57,34,1,5,-17,43,39,29,17,10,0,-2,26,23,-2,-5,-7,FLAT
0,8,33,41,60,64,50,58,-17,8,27,0,17,9,32,-17,26,47,56,17,-7,8,25,26,FLAT
-3,32,5,37,41,60,64,50,0,-31,-27,-3,-17,-23,0,-3,17,-22,5,-20,26,16,29,14,FLAT
3,26,6,32,37,41,60,64,-3,4,9,3,-3,-27,-18,0,-20,-19,9,0,14,-18,14,-17,FLAT
-51,11,55,66,32,37,41,60,3,-2,-36,-51,0,2,-27,-48,0,-29,-54,-51,-17,-21,-27,-51,FLAT
25,35,16,51,66,32,37,41,-51,-14,1,25,-48,-16,-35,-26,-51,-12,-26,-23,-51,-43,-53,-26,FLAT
-23,27,30,57,51,66,32,37,25,-9,-15,-23,-26,-23,-14,2,-23,-25,-50,-49,-26,-21,-41,-46,FLAT
-3,25,19,44,57,51,66,32,-23,-14,-1,-3,2,-23,-16,-26,-49,-37,-15,-1,-46,-39,-51,-52,FLAT
40,69,3,72,44,57,51,66,-3,24,-4,40,-26,10,-5,37,-1,1,-20,14,-52,-13,-19,39,FLAT
-85,15,97,112,72,44,57,51,40,9,-31,-85,37,33,-35,-45,14,19,-36,-48,39,10,-51,-71,FLAT
-15,44,40,84,99,112,72,44,96,24,39,-15,11,24,52,81,51,33,21,-4,48,57,17,36,FLAT
388,397,100,497,84,99,112,72,-15,448,35,388,81,472,74,373,-4,472,87,469,36,481,56,384,FLAT
-38,149,97,246,497,84,99,112,388,-41,210,-38,373,407,245,350,469,431,284,335,384,431,297,431,FLAT
186,204,8,212,246,497,84,99,-38,97,131,186,350,56,341,148,335,504,376,536,431,528,415,521,FLAT
56,85,21,106,212,246,497,84,186,69,175,56,148,166,306,242,536,125,516,204,521,573,551,592,FLAT
13,20,89,109,106,212,246,497,56,81,78,13,242,150,253,69,204,247,384,255,592,206,594,217,FLAT
142,146,27,173,109,106,212,246,13,80,16,142,69,161,94,155,255,230,269,211,217,327,400,397,FLAT
12,102,39,141,173,109,106,212,142,24,56,12,155,104,72,154,211,185,150,167,397,254,325,223,FLAT
6,46,68,114,141,173,109,106,12,35,62,6,154,59,118,18,167,139,134,160,223,220,212,173,FLAT
173,184,4,188,114,141,173,109,6,109,35,173,18,144,97,179,160,168,153,191,173,248,169,333,FLAT
34,66,30,96,188,114,141,173,173,60,152,34,179,169,187,207,191,204,249,213,333,228,305,225,FLAT
-81,15,101,116,96,188,114,141,34,-10,-30,-81,207,50,122,-47,213,159,157,126,225,194,219,132,FLAT
130,130,2,132,116,96,188,114,-81,31,15,130,-47,21,-15,49,126,81,137,83,132,190,172,256,FLAT
-74,17,74,91,132,116,96,188,130,-2,39,-74,49,29,54,56,83,19,24,-25,256,79,176,9,FLAT
43,55,30,85,91,132,116,96,-74,-1,5,43,56,-3,44,-31,-25,28,59,99,9,18,29,18,FLAT
52,70,14,84,85,91,132,116,43,36,37,52,-31,35,42,95,99,33,81,21,18,64,96,151,FLAT
30,55,4,59,84,85,91,132,52,20,45,30,95,56,82,82,21,55,87,125,151,53,126,51,FLAT
-26,12,58,70,59,84,85,91,30,28,17,-26,82,48,62,4,125,84,99,56,51,83,104,99,FLAT
42,56,8,64,70,59,84,85,-26,-8,-2,42,4,20,15,16,56,40,60,46,99,76,97,98,FLAT
-38,14,46,60,64,70,59,84,42,0,4,-38,16,-8,2,4,46,20,19,-22,98,40,64,8,FLAT
-18,18,41,59,60,64,70,59,-38,-23,-22,-18,4,-23,-18,-56,-22,-31,-20,-14,8,-3,-3,-40,FLAT
3,18,26,44,59,60,64,70,-18,-12,3,3,-56,-35,-19,-15,-14,-35,-15,-53,-40,-43,-17,-11,FLAT
32,50,3,53,44,59,60,64,3,9,0,32,-15,-3,3,35,-53,-26,-19,17,-11,-26,-15,-21,FLAT
14,34,2,36,52,27,27,56,-24,-28,-12,14,-33,-27,-36,-10,-17,-18,-27,-19,20,-17,3,-3,FLAT
-1,13,8,21,36,52,27,27,14,5,20,-1,-10,-23,8,13,-19,-22,-16,-11,-3,-13,-7,-20,FLAT
3,18,6,24,21,36,52,27,-1,1,-2,3,13,6,18,2,-11,-22,6,16,-20,-21,-18,-8,FLAT
20,20,7,27,24,21,36,52,3,21,18,20,2,22,16,23,16,27,36,22,-8,-1,24,36,FLAT
-70,3,71,74,27,24,21,36,20,-6,-53,-70,23,15,-35,-50,22,16,-37,-47,36,21,-17,-48,FLAT
0,13,24,37,74,27,24,21,-70,-47,-10,0,-50,-53,-63,-70,-47,-32,-45,-50,-48,-31,-47,-47,FLAT
-13,2,35,37,37,74,27,24,0,-2,-2,-13,-70,-49,-12,-13,-50,-55,-65,-83,-47,-34,-47,-63,FLAT
17,24,19,43,37,37,74,27,-13,1,-5,17,-13,-1,-7,4,-83,-48,-17,4,-63,-54,-70,-66,FLAT
-103,13,104,117,43,37,37,74,17,-18,-92,-103,4,-17,-97,-86,4,-19,-99,-99,-66,-66,-109,-99,FLAT
84,86,15,101,117,43,37,37,-103,-5,11,84,-86,-23,-81,-19,-99,-22,-86,-2,-99,-24,-88,-15,FLAT
-26,46,32,78,90,101,117,43,76,0,12,-26,160,67,90,50,57,62,101,134,74,44,9,31,FLAT
40,71,18,89,78,90,101,117,-26,26,15,40,50,26,27,14,134,93,105,90,31,88,116,174,FLAT
81,110,13,123,89,78,90,101,40,76,42,81,14,102,57,121,90,102,69,95,174,169,147,171,FLAT
-155,43,155,198,123,89,78,90,81,-13,-88,-155,121,63,-46,-74,95,89,-31,-34,171,89,-19,-60,FLAT
19,67,26,93,198,123,89,78,-155,-110,-5,19,-74,-123,-93,-136,-34,-47,-51,-55,-60,-21,-36,-15,FLAT
124,125,4,129,93,198,123,89,19,102,66,124,-136,-8,61,143,-55,-21,-27,-12,-15,55,15,69,FLAT
14,56,15,71,129,93,198,123,124,25,83,14,143,127,149,138,-12,17,144,157,69,4,56,2,FLAT
67,131,17,148,71,129,93,198,14,69,-8,67,138,94,75,81,157,196,141,205,2,86,136,224,FLAT
55,94,3,97,148,71,129,93,67,41,92,55,81,110,84,122,205,135,167,136,224,237,233,260,FLAT
-81,4,93,97,97,148,71,129,55,9,9,-81,122,50,101,-26,136,119,93,41,260,144,176,55,FLAT
24,82,9,91,97,97,148,71,-81,-60,-54,24,-26,-51,-45,-57,41,-10,47,-2,55,59,39,65,FLAT
22,54,25,79,91,97,97,148,24,38,50,22,-57,-22,-4,46,-2,-13,5,-35,65,28,97,20,FLAT
85,114,5,119,79,91,97,97,22,65,25,85,46,103,75,107,-35,43,21,131,20,52,30,50,FLAT
-11,50,18,68,119,79,91,97,85,2,53,-11,107,67,78,74,131,105,128,96,50,45,74,120,FLAT
-90,38,98,136,68,119,79,91,-11,-10,-78,-90,74,-8,-25,-101,96,57,0,-16,120,95,50,6,FLAT
11,55,11,66,136,68,119,79,-90,-76,-6,11,-101,-86,-84,-79,-16,-84,-31,-90,6,-19,-6,-5,FLAT
3,58,40,98,66,136,68,119,11,32,0,3,-79,-44,-6,14,-90,-54,-84,-76,-5,-52,-31,-87,FLAT
62,80,0,80,98,66,136,68,3,22,40,62,14,54,40,65,-76,-22,34,76,-87,-32,-44,-14,FLAT
20,35,8,43,80,98,66,136,62,28,65,20,65,50,105,82,76,82,105,85,-14,6,99,96,FLAT
-29,10,37,47,43,80,98,66,20,0,-4,-29,82,28,61,-9,85,50,101,53,96,82,101,56,FLAT
34,35,41,76,47,43,80,98,-29,38,9,34,-9,38,5,5,53,66,70,25,56,88,110,87,FLAT
4,59,5,64,76,47,43,80,34,-32,-20,4,5,6,-11,38,25,6,-15,9,87,34,50,29,FLAT
55,56,33,89,64,76,47,43,4,83,58,55,38,51,38,59,9,89,47,93,29,89,43,64,FLAT
-5,45,62,107,89,64,76,47,55,24,6,-5,59,107,64,50,93,75,44,54,64,113,53,88,FLAT
-52,125,160,285,107,89,64,76,-5,46,-132,-52,50,70,-126,-57,54,153,-68,-2,88,121,-88,2,FLAT
55,154,2,156,285,107,89,64,-52,-103,26,55,-57,-57,-106,3,-2,-33,-100,-2,2,50,-42,53,FLAT
31,65,20,85,156,285,107,89,55,49,120,31,3,-54,146,86,-2,-8,14,34,53,16,20,29,FLAT
-28,19,51,70,85,156,285,107,31,3,18,-28,86,52,138,3,34,-51,164,58,29,-5,32,6,FLAT
135,135,10,145,70,85,156,285,-28,94,19,135,3,97,37,107,58,146,157,138,6,43,183,193,FLAT
8,65,8,73,145,70,85,156,135,6,78,8,107,100,97,143,138,103,115,115,193,152,235,146,FLAT
-46,25,49,74,73,145,70,85,8,-5,-6,-46,143,1,72,-38,115,95,91,97,146,98,109,69,FLAT
-86,0,88,88,74,73,145,70,-46,-47,-61,-86,-38,-52,-67,-132,97,-46,11,-124,69,48,30,11,FLAT
56,62,32,94,88,74,73,145,-86,0,-6,56,-132,-47,-67,-30,-124,-52,-73,-76,11,-46,5,-68,FLAT
93,151,2,153,94,88,74,73,56,63,4,93,-30,63,-2,149,-76,16,-63,63,-68,11,-69,17,FLAT
-62,40,69,109,153,94,88,74,93,5,49,-62,149,68,53,31,63,68,47,87,17,21,-14,1,FLAT
15,15,32,47,109,153,94,88,-62,-22,40,15,31,-17,89,-47,87,46,93,46,1,46,87,102,FLAT
-11,26,41,67,47,109,153,94,15,-2,-22,-11,-47,-24,18,4,46,-19,67,-58,102,44,71,35,FLAT
26,55,20,75,67,47,109,153,-11,5,-3,26,4,3,-25,15,-58,-19,15,30,35,-14,64,-32,FLAT
85,96,22,118,75,67,47,109,26,87,44,85,15,92,41,111,30,90,19,100,-32,68,59,115,FLAT
37,45,15,60,118,75,67,47,85,30,88,37,111,117,132,122,100,122,129,148,115,120,107,137,FLAT
-3,26,44,70,60,118,75,67,37,26,16,-3,122,56,104,34,148,143,148,119,137,148,145,145,FLAT
11,28,14,42,70,60,118,75,-3,-19,9,11,34,7,25,8,119,37,113,45,145,124,157,130,FLAT
-13,23,39,62,42,70,60,118,11,12,-8,-13,8,-7,1,-2,45,19,17,-5,130,49,105,32,FLAT
21,23,9,32,62,42,70,60,-13,-9,21,21,-2,3,13,8,-5,-16,22,19,32,10,38,16,FLAT
71,72,0,72,32,62,42,70,21,62,22,71,8,53,43,92,19,65,35,79,16,46,44,90,FLAT
21,24,28,52,72,32,62,42,71,49,69,21,92,111,91,92,79,102,112,113,90,114,104,100,FLAT
1,10,14,24,42,63,27,40,23,-4,14,1,55,17,56,24,58,64,67,56,75,51,67,59,FLAT
-1,9,12,21,80,24,42,63,-76,-65,-6,-1,-75,-79,-76,-77,-52,-83,-62,-76,-20,-62,-20,-53,FLAT
36,40,1,41,21,80,24,42,-1,25,5,36,-77,-40,-1,35,-76,-54,-71,-41,-53,-58,-57,-40,FLAT
-42,3,47,50,41,21,80,24,36,4,-5,-42,35,29,0,-6,-41,-36,-6,-7,-40,-50,-76,-83,FLAT
-2,17,24,41,50,41,21,80,-42,-25,-16,-2,-6,-21,-21,-44,-7,4,-16,-8,-83,-61,-22,-9,FLAT
5,29,5,34,41,50,41,21,-2,-14,-7,5,-44,-39,-23,3,-8,-35,-28,-39,-9,-10,-23,-3,FLAT
-55,9,59,68,34,41,50,41,5,-1,-35,-55,3,-15,-42,-50,-39,-40,-58,-52,-3,-36,-63,-94,FLAT
-85,8,106,114,68,34,41,50,-55,-38,-84,-85,-50,-39,-119,-140,-52,-53,-126,-135,-94,-78,-142,-137,FLAT
42,42,22,64,114,68,34,41,-85,-42,8,42,-140,-80,-76,-43,-135,-81,-111,-98,-137,-95,-118,-93,FLAT
-74,15,79,94,64,114,68,34,42,-17,-47,-74,-43,-59,-39,-32,-98,-97,-123,-117,-93,-98,-158,-172,FLAT
8,17,20,37,94,64,114,68,-74,-51,6,8,-32,-68,-41,-66,-117,-110,-33,-24,-172,-148,-117,-109,FLAT
-68,46,68,114,37,94,64,114,8,-20,-97,-68,-66,-71,-91,-60,-24,-88,-138,-134,-109,-130,-130,-92,FLAT
16,32,53,85,114,37,94,64,-68,1,30,16,-60,-19,-67,-52,-134,-70,-61,-44,-92,-87,-108,-118,FLAT
-38,38,48,86,85,114,37,94,16,-43,-44,-38,-52,-42,-14,-22,-44,-62,-111,-90,-118,-113,-105,-82,FLAT
116,116,2,118,59,86,85,114,20,103,44,116,-18,90,58,136,-2,47,14,98,-70,48,44,114,FLAT
38,40,20,60,118,59,86,85,116,56,114,38,136,159,158,154,98,146,172,174,114,103,128,136,FLAT
50,66,21,87,60,118,59,86,38,51,24,50,154,107,138,88,174,210,182,204,136,197,196,224,FLAT
-1,24,58,82,87,60,118,59,50,36,41,-1,88,87,65,49,204,143,179,87,224,246,223,203,FLAT
10,27,13,40,82,87,60,118,-1,-35,7,10,49,1,48,9,87,52,72,59,203,108,186,97,FLAT
118,121,19,140,40,82,87,60,10,124,24,118,9,89,31,128,59,125,72,127,97,176,96,177,FLAT
-25,36,35,71,101,140,40,82,-77,-75,-45,-25,41,-86,-17,-102,51,38,7,16,50,3,14,26,FLAT
-62,6,71,77,71,101,140,40,-25,-26,-32,-62,-102,-101,-77,-87,16,-112,-49,-164,26,12,-25,-46,FLAT
-55,4,56,60,77,71,101,140,-62,-70,-53,-55,-87,-96,-85,-117,-164,-171,-130,-142,-46,-182,-102,-219,FLAT
-36,2,67,69,60,77,71,101,-55,-25,-34,-36,-117,-95,-87,-91,-142,-121,-119,-153,-219,-196,-164,-178,FLAT
-21,0,77,77,69,60,77,71,-36,-11,-19,-21,-91,-36,-53,-57,-153,-106,-106,-112,-178,-132,-138,-174,FLAT
77,87,3,90,60,77,69,60,48,68,38,77,27,51,38,125,-9,40,19,104,-64,15,-15,68,FLAT
46,64,0,64,90,60,77,69,77,43,69,46,125,111,107,123,104,94,107,171,68,83,88,150,FLAT
-42,29,60,89,64,90,60,77,46,18,-7,-42,123,61,62,4,171,129,100,81,150,112,100,129,FLAT
-63,3,80,83,114,89,64,90,-41,-83,-52,-63,-83,-84,-78,-104,-37,-66,-85,-146,40,-23,-16,-100,FLAT
8,33,51,84,83,114,89,64,-63,-21,-22,8,-104,-104,-74,-55,-146,-105,-100,-96,-100,-87,-107,-138,FLAT
-52,35,102,137,84,83,114,89,8,-1,-54,-52,-55,-22,-76,-44,-96,-105,-128,-107,-138,-106,-154,-148,FLAT
-18,65,22,87,136,137,84,83,123,-9,40,-18,71,25,75,105,79,24,21,53,16,3,-1,61,FLAT
40,68,7,75,87,136,137,84,-18,25,37,40,105,16,77,22,53,50,112,145,61,49,58,93,FLAT
51,64,6,70,75,87,136,137,40,50,55,51,22,75,92,91,145,66,132,73,93,100,167,196,FLAT
70,105,39,144,70,75,87,136,51,103,29,70,91,153,84,121,73,178,121,161,196,169,161,143,FLAT
-93,156,93,249,144,70,75,87,70,-39,-144,-93,121,64,-115,-23,161,114,-60,28,143,139,-23,68,FLAT
34,125,32,157,249,144,70,75,-93,-27,65,34,-23,-66,-79,-59,28,37,-50,11,68,87,5,62,FLAT
22,100,8,108,157,249,144,70,34,-2,47,22,-59,-29,112,56,11,-68,-32,-37,62,35,-3,33,FLAT
52,108,27,135,108,157,249,144,22,71,44,52,56,69,91,74,-37,42,156,108,33,3,12,15,FLAT
-10,43,36,79,135,108,157,249,52,-1,55,-10,74,70,99,42,108,68,146,64,15,41,211,98,FLAT
-28,14,38,52,79,135,108,157,-10,-26,1,-28,42,-27,56,-38,64,44,100,14,98,42,147,36,FLAT
-1,3,55,58,52,79,135,108,-28,16,10,-1,-38,-10,11,-29,14,-11,66,-39,36,60,110,13,FLAT
-22,7,26,33,58,52,79,135,-1,-51,-26,-22,-29,-35,-16,-23,-39,-61,-15,-51,13,-62,40,-61,FLAT
16,33,35,68,33,58,52,79,-22,25,-10,16,-23,-26,-36,-6,-51,-10,-26,-7,-61,-36,-25,-35,FLAT
4,12,25,37,68,33,58,52,16,-6,25,4,-6,19,15,20,-7,-32,-11,-2,-35,-16,-1,-3,FLAT
14,61,10,71,37,68,33,58,4,-1,-35,14,20,-7,-10,18,-2,18,-20,34,-3,-33,-46,12,FLAT
4,21,37,58,71,37,68,33,14,31,44,4,18,30,9,18,34,24,34,22,12,49,24,38,FLAT
-103,4,108,112,58,71,37,68,4,-32,-86,-103,18,-1,-42,-99,22,-2,-77,-85,38,-8,-52,-81,FLAT
19,45,5,50,112,58,71,37,-103,-84,-22,19,-99,-116,-108,-84,-85,-85,-64,-80,-81,-86,-99,-66,FLAT
28,28,25,53,50,112,58,71,19,48,45,28,-84,-36,23,47,-80,-68,-63,-56,-66,-37,-19,-52,FLAT
3,17,20,37,53,50,112,58,28,-2,14,3,47,46,59,31,-56,-38,37,50,-52,-70,-49,-53,FLAT
5,6,19,25,33,31,41,49,2,0,8,5,5,4,10,7,-7,-1,15,10,23,3,27,-2,FLAT
-27,15,27,42,25,33,31,41,5,-19,-36,-27,7,-19,-28,-22,10,-15,-26,-20,-2,-20,-21,-17,FLAT
6,18,4,22,42,25,33,31,-27,-17,3,6,-22,-36,-33,-21,-20,-36,-25,-16,-17,-32,-23,-14,FLAT
8,20,4,24,22,42,25,33,6,8,6,8,-21,-9,9,14,-16,-28,-27,-13,-14,-28,-19,-8,FLAT
17,24,7,31,24,22,42,25,8,20,13,17,14,28,19,25,-13,11,22,31,-8,-8,-14,4,FLAT
5,15,10,25,31,24,22,42,17,8,14,5,25,28,27,22,31,36,33,30,4,19,36,36,FLAT
-15,6,27,33,25,31,24,22,5,2,-6,-15,22,10,8,-10,30,30,21,7,36,38,27,15,FLAT
-28,1,59,60,33,25,31,24,-15,4,-23,-28,-10,6,-29,-43,7,14,-15,-38,15,34,-2,-21,FLAT
95,103,20,123,60,33,25,31,-28,56,-7,95,-43,60,-30,67,-38,62,-36,52,-21,70,-22,57,FLAT
-57,13,57,70,123,60,33,25,95,-20,33,-57,67,36,26,38,52,40,3,10,57,42,-3,-5,FLAT
16,60,11,71,70,123,60,33,-57,-30,-31,16,38,-50,2,-41,10,6,-5,54,-5,10,-28,26,FLAT
53,72,0,72,71,70,123,60,16,42,41,53,-41,12,10,69,54,-8,43,12,26,48,36,107,FLAT
-4,14,68,82,72,71,70,123,53,64,54,-4,69,106,95,49,12,76,64,65,107,56,97,8,FLAT
74,113,24,137,82,72,71,70,-4,30,-25,74,49,94,29,70,65,136,70,123,8,106,39,139,FLAT
21,68,6,74,137,82,72,71,74,3,66,21,70,33,41,95,123,97,95,91,139,139,136,144,FLAT
-91,13,97,110,74,137,82,72,21,0,-36,-91,95,3,30,-70,91,33,5,4,144,97,59,0,FLAT
111,121,3,124,110,74,137,82,-91,17,3,111,-70,17,-33,20,4,20,33,41,0,50,8,115,FLAT
-13,41,13,54,124,110,74,137,111,-3,67,-13,20,14,70,98,41,14,34,7,115,17,100,28,FLAT
-46,26,58,84,54,124,110,74,-13,-1,-31,-46,98,-4,36,-59,7,13,39,52,28,13,3,-39,FLAT
72,81,27,108,84,54,124,110,-46,41,17,72,-59,40,-14,26,52,37,53,13,-39,54,56,124,FLAT
44,50,20,70,118,108,84,54,-81,-40,8,44,-9,-44,-6,-37,-55,-3,11,35,-68,-4,-20,-11,FLAT
-57,6,58,64,70,118,108,84,44,-19,-13,-57,-37,-59,-5,-13,35,-63,-19,-94,-11,-22,-2,-22,FLAT
39,51,19,70,64,70,118,108,-57,0,-6,39,-13,-19,-19,-18,-94,-59,-11,26,-22,-63,-25,-55,FLAT
27,88,16,104,70,64,70,118,39,24,-10,27,-18,24,-16,66,26,5,-29,9,-55,-35,-21,53,FLAT
-35,7,36,43,104,70,64,70,27,-15,46,-35,66,9,36,-8,9,9,30,31,53,-10,17,-26,FLAT
-9,24,18,42,43,104,70,64,-35,-27,-26,-9,-8,-42,20,-44,31,-18,10,-17,-26,-18,4,22,FLAT
-52,6,61,67,42,43,104,70,-9,-9,-34,-52,-44,-36,-60,-61,-17,-51,-14,-96,22,-27,-24,-69,FLAT
-25,4,48,52,67,42,43,104,-52,-38,-23,-25,-61,-47,-57,-77,-96,-74,-83,-86,-69,-89,-37,-121,FLAT
46,66,6,72,52,67,42,43,-25,4,-16,46,-77,-34,-39,21,-86,-43,-73,-31,-121,-70,-99,-40,FLAT
3,24,16,40,72,52,67,42,46,13,45,3,21,17,29,49,-31,-21,6,24,-40,-30,-28,-28,FLAT
-11,2,25,27,40,72,52,67,3,-2,11,-11,49,11,56,-8,24,15,40,38,-28,-23,17,13,FLAT
-13,46,33,79,27,40,72,52,-11,-5,-57,-13,-8,-7,-46,-24,38,6,-1,-21,13,10,-17,25,FLAT
-21,53,55,108,79,27,40,72,-13,1,-28,-21,-24,-4,-85,-34,-21,-6,-74,-45,25,7,-29,-42,FLAT
-30,35,50,85,108,79,27,40,-21,-35,-12,-30,-34,-34,-40,-51,-45,-39,-97,-64,-42,-41,-86,-75,FLAT
-17,41,32,73,85,108,79,27,-30,-35,-23,-17,-51,-70,-35,-47,-64,-69,-63,-68,-75,-74,-120,-81,FLAT
85,146,4,150,73,85,108,79,-17,57,-20,85,-47,22,-43,68,-68,-13,-55,38,-81,-12,-83,17,FLAT
-68,7,71,78,150,73,85,108,85,-1,71,-68,68,56,51,17,38,21,28,0,17,-14,16,-30,FLAT
-69,18,99,117,78,150,73,85,-68,-41,-80,-69,17,-42,-9,-137,0,15,-29,-52,-30,-20,-52,-69,FLAT
-126,17,140,157,117,78,150,73,-69,-85,-125,-126,-137,-126,-205,-195,-52,-127,-134,-263,-69,-70,-154,-178,FLAT
122,180,12,192,157,117,78,150,-126,-6,-41,122,-195,-91,-166,-4,-263,-132,-246,-73,-178,-133,-175,-141,FLAT
-42,12,67,79,66,192,157,117,34,8,-5,-42,156,47,160,-8,30,41,119,114,-39,-44,-6,-12,FLAT
93,122,4,126,79,66,192,157,-42,30,-17,93,-8,38,-22,51,114,77,143,85,-12,71,102,207,FLAT
21,43,14,57,126,79,66,192,93,31,100,21,51,61,83,114,85,69,78,72,207,108,243,106,FLAT
-14,52,25,77,57,126,79,66,21,-3,-23,-14,114,28,77,7,72,58,60,100,106,66,55,58,FLAT
38,50,6,56,77,57,126,79,-14,19,40,38,7,16,17,24,100,47,117,45,58,77,100,138,FLAT
-10,5,47,52,56,77,57,126,38,31,35,-10,24,50,75,28,45,47,52,14,138,78,152,35,FLAT
18,38,9,47,52,56,77,57,-10,-20,-15,18,28,11,20,8,14,30,60,46,35,27,37,32,FLAT
-3,16,35,51,47,52,56,77,18,23,19,-3,8,3,4,15,46,34,39,5,32,53,79,43,FLAT
-11,9,15,24,51,47,52,56,-3,-31,-4,-11,15,-8,15,-14,5,-28,0,4,43,3,35,-6,FLAT
-16,21,25,46,24,51,47,52,-11,-6,-28,-16,-14,-37,-32,-27,4,-14,-13,-30,-6,-34,-28,-12,FLAT
7,9,14,23,46,24,51,47,-16,-4,19,7,-27,-10,-9,-9,-30,-41,-13,-20,-12,-18,6,-23,FLAT
18,26,9,35,23,46,24,51,7,13,1,18,-9,9,20,25,-20,3,-8,9,-23,-28,-12,-2,FLAT
-4,5,18,23,35,23,46,24,18,5,17,-4,25,18,18,14,9,14,37,21,-2,8,9,5,FLAT
76,91,0,91,23,35,23,46,-4,58,-10,76,14,63,7,72,21,76,8,90,5,72,27,97,FLAT
-14,27,40,67,91,23,35,23,76,26,50,-14,72,84,40,62,90,89,57,58,97,102,58,76,FLAT
-1,6,10,16,30,67,42,32,10,4,18,-1,75,19,70,9,62,62,88,74,77,65,81,61,FLAT
9,11,16,27,16,30,67,42,-1,15,4,9,9,19,22,8,74,34,74,18,61,77,92,83,FLAT
0,15,10,25,27,16,30,67,9,-6,-4,0,8,9,0,9,18,13,18,8,83,28,70,18,FLAT
-17,6,28,34,25,27,16,30,0,1,-8,-17,9,-5,-12,-17,8,10,-8,-8,18,14,10,-9,FLAT
-12,15,12,27,34,25,27,16,-17,-28,-21,-12,-17,-27,-29,-29,-8,-33,-33,-29,-9,-18,-29,-20,FLAT
59,68,5,73,27,34,25,27,-12,52,6,59,-29,24,-15,47,-29,25,-23,30,-20,19,-27,30,FLAT
3,6,24,30,73,27,34,25,59,22,65,3,47,74,71,62,30,46,50,50,30,47,42,33,FLAT
15,21,6,27,30,73,27,34,3,-3,0,15,62,19,65,18,50,71,71,77,33,43,50,65,FLAT
-95,6,141,147,27,30,73,27,15,40,-80,-95,18,37,-80,-80,77,59,-15,-77,65,111,-9,-18,FLAT
-28,3,44,47,147,27,30,73,-95,-125,-25,-28,-80,-85,-105,-123,-77,-88,-105,-108,-18,-66,-40,-105,FLAT
5,73,35,108,47,147,27,30,-28,-4,-65,5,-123,-129,-90,-23,-108,-89,-170,-118,-105,-92,-170,-103,FLAT
41,44,12,56,108,47,147,27,5,18,70,41,-23,14,5,46,-118,-111,-20,18,-103,-71,-100,-77,FLAT
44,50,11,61,56,108,47,147,41,43,38,44,46,61,108,85,18,57,43,90,-77,-68,18,62,FLAT
154,186,5,191,61,56,108,47,44,148,18,154,85,191,56,198,90,209,126,239,62,205,61,244,FLAT
-38,35,44,79,191,61,56,108,154,1,113,-38,198,149,131,116,239,192,169,160,244,210,239,201,FLAT
-43,37,122,159,79,191,61,56,-38,35,-45,-43,116,36,68,-81,160,184,86,73,201,227,124,117,FLAT
-62,16,66,82,230,159,79,191,-97,-119,29,-62,-140,-215,-138,-159,-178,-180,-183,-202,-24,-179,-70,-240,FLAT
2,25,84,109,82,230,159,79,-62,20,-7,2,-159,-99,22,-60,-202,-195,-145,-157,-240,-160,-190,-200,FLAT
-83,47,87,134,109,82,230,159,2,-80,-105,-83,-60,-60,-112,-81,-157,-179,-83,-143,-200,-275,-250,-240,FLAT
-24,94,39,133,134,109,82,230,-83,-72,-71,-24,-81,-152,-176,-107,-143,-132,-183,-105,-240,-251,-154,-167,FLAT
43,43,31,74,133,134,109,82,-24,35,94,43,-107,-37,23,19,-105,-117,-82,-64,-167,-97,-89,-62,FLAT
-45,28,70,98,72,74,133,134,29,24,-2,-45,72,23,-1,-16,48,58,93,27,-35,-14,22,3,FLAT
90,95,6,101,98,72,74,133,-45,26,23,90,-16,50,21,45,27,49,22,74,3,84,116,117,FLAT
-4,8,28,36,101,98,72,74,90,18,83,-4,45,44,106,86,74,68,104,41,117,67,105,70,FLAT
20,36,8,44,36,101,98,72,-4,0,-8,20,86,18,75,16,41,44,98,106,70,68,96,61,FLAT
65,75,31,106,44,36,101,98,20,88,26,65,16,88,18,85,106,106,101,81,61,132,124,171,FLAT
5,64,11,75,106,44,36,101,65,-15,16,5,85,73,42,70,81,73,34,90,171,91,117,86,FLAT
-84,22,88,110,75,106,44,36,5,-7,-42,-84,70,-22,-26,-79,90,66,0,-14,86,66,-8,6,FLAT
23,33,46,79,110,75,106,44,-84,-19,12,23,-79,-26,-30,-61,-14,-41,-14,-56,6,47,12,9,FLAT
-85,12,90,102,79,110,75,106,23,-41,-64,-85,-61,-60,-52,-62,-56,-67,-94,-146,9,-82,-78,-141,FLAT
105,110,23,133,102,79,110,75,-85,38,7,105,-62,-3,-57,20,-146,-22,-45,43,-141,-29,-87,-41,FLAT
7,35,36,71,112,133,102,79,-54,-55,-14,7,51,-34,28,-47,-34,4,35,58,-11,-37,-29,-27,FLAT
-223,32,437,469,71,112,133,102,7,178,-220,-223,-47,123,-234,-216,58,144,-192,-270,-27,182,-185,-165,FLAT
135,144,26,170,469,71,112,133,-223,-276,23,135,-216,-98,-197,-88,-270,-153,-211,-81,-165,-132,-169,-135,FLAT
-53,34,88,122,170,469,71,112,135,9,57,-53,-88,-267,80,82,-81,-89,-140,-141,-135,-144,-154,-134,FLAT
-29,15,143,158,122,170,469,71,-53,26,-10,-29,82,35,47,-82,-141,-241,70,53,-134,-63,-150,-170,FLAT
-33,67,115,182,158,122,170,469,-29,-61,-85,-33,-82,-35,-95,-62,53,-26,-38,-115,-170,-302,-15,20,FLAT
-16,100,58,158,182,158,122,170,-33,-73,-49,-16,-62,-134,-134,-49,-115,-108,-144,-78,20,-99,-87,-131,FLAT
67,85,65,150,158,182,158,122,-16,74,82,67,-49,1,33,51,-78,-60,-52,18,-131,-34,-62,-11,FLAT
14,46,46,92,150,158,182,158,67,-5,53,14,51,69,135,81,18,-4,86,65,-11,-65,1,32,FLAT
21,34,31,65,92,150,158,182,14,6,33,21,81,1,86,35,65,75,168,102,32,2,119,86,FLAT
-1,58,31,89,65,92,150,158,21,-1,-25,-1,35,5,8,20,102,0,61,34,86,74,143,101,FLAT
46,81,41,122,89,65,92,150,-1,56,23,46,20,55,-2,45,34,61,31,66,101,56,84,80,FLAT
-124,9,125,134,122,89,65,92,46,-40,-52,-124,45,16,-29,-78,66,15,-54,-79,80,21,-21,-58,FLAT
-39,34,47,81,134,122,89,65,-124,-117,-64,-39,-78,-157,-116,-163,-79,-101,-93,-117,-58,-102,-118,-118,FLAT
-29,10,45,55,81,134,122,89,-39,-31,-5,-29,-163,-148,-69,-68,-117,-188,-121,-192,-118,-132,-98,-146,FLAT
19,39,9,48,55,81,134,122,-29,-17,-10,19,-68,-48,-15,-10,-192,-165,-79,-49,-146,-205,-131,-173,FLAT
26,29,17,46,48,55,81,134,19,34,36,26,-10,17,26,45,-49,-14,21,16,-173,-131,-43,-23,FLAT
-97,4,98,102,46,48,55,81,26,-16,-72,-97,45,18,-36,-71,16,1,-46,-52,-23,-30,-51,-81,FLAT
-24,58,26,84,102,46,48,55,-97,-96,-78,-24,-71,-112,-150,-121,-52,-78,-114,-95,-81,-95,-124,-76,FLAT
15,70,8,78,84,102,46,48,-24,-3,3,15,-121,-99,-75,-9,-95,-115,-147,-106,-76,-81,-111,-80,FLAT
27,33,8,41,78,84,102,46,15,27,64,27,-9,24,67,42,-106,-72,-11,18,-80,-88,-83,-79,FLAT
-4,16,13,29,41,78,84,102,27,1,13,-4,42,28,77,23,18,25,80,38,-79,-71,2,14,FLAT
3,10,23,33,29,41,78,84,-4,13,9,3,23,14,22,-1,38,41,86,26,14,38,89,41,FLAT
-4,12,4,16,36,22,45,39,15,0,20,-4,23,6,12,11,49,19,48,19,54,26,49,45,FLAT
0,24,4,28,16,36,22,45,-4,0,-12,0,11,0,8,-4,19,6,0,11,45,19,36,19,FLAT
-13,21,13,34,28,16,36,22,0,-4,-10,-13,-4,-4,-22,-13,11,-4,-2,-17,19,2,-10,-2,FLAT
-13,11,18,29,34,28,16,36,-13,-8,-3,-13,-13,-12,-13,-26,-17,-12,-25,-26,-2,-12,-5,-30,FLAT
-20,20,21,41,29,34,28,16,-13,-17,-29,-20,-26,-25,-32,-33,-26,-29,-42,-46,-30,-29,-54,-46,FLAT
16,30,5,35,41,29,34,28,-20,0,6,16,-33,-17,-23,-4,-46,-25,-26,-17,-46,-29,-36,-30,FLAT
18,24,9,33,35,41,29,34,16,22,24,18,-4,22,30,34,-17,5,1,14,-30,-3,-2,1,FLAT
46,46,23,69,33,35,41,29,18,60,24,46,34,82,48,64,14,82,54,80,1,65,25,60,FLAT
57,76,3,79,69,33,35,41,46,37,27,57,64,97,51,103,80,119,75,121,60,119,81,137,FLAT
-172,11,175,186,79,69,33,35,57,0,-107,-172,103,37,-80,-115,121,97,-56,-69,137,119,-32,-51,FLAT
-11,51,18,69,186,79,69,33,-172,-168,-51,-11,-115,-168,-158,-183,-69,-131,-131,-126,-51,-71,-107,-80,FLAT
-184,27,190,217,69,186,79,69,-11,-12,-160,-184,-183,-180,-211,-195,-126,-180,-318,-367,-80,-143,-291,-310,FLAT
143,143,30,173,217,69,186,79,-184,-17,27,143,-195,-29,-133,-41,-367,-197,-184,-52,-310,-197,-291,-224,FLAT
138,143,24,167,173,217,69,186,143,132,138,138,-41,115,165,281,-52,103,5,97,-224,-65,-46,86,FLAT
42,91,34,125,167,173,217,69,138,52,94,42,281,184,232,180,97,167,259,323,86,155,99,139,FLAT
10,36,53,89,125,167,173,217,42,29,65,10,180,81,159,52,323,213,297,190,139,196,324,333,FLAT
-49,18,76,94,89,125,167,173,10,-26,-31,-49,52,3,34,-39,190,55,128,3,333,187,266,141,FLAT
-21,17,70,87,94,89,125,167,-49,-27,-20,-21,-39,-53,-51,-70,3,-24,14,-60,141,28,108,-18,FLAT
-9,30,32,62,87,94,89,125,-21,-47,-22,-9,-70,-74,-42,-30,-60,-100,-73,-79,-18,-71,-8,-69,FLAT
-20,20,31,51,62,87,94,89,-9,-21,-10,-20,-30,-68,-32,-29,-79,-95,-52,-50,-69,-121,-83,-99,FLAT
103,123,3,126,51,62,87,94,-20,75,0,103,-29,54,-10,83,-50,7,-32,74,-99,-20,-52,53,FLAT
28,96,11,107,126,51,62,87,103,36,55,28,83,111,55,131,74,90,45,111,53,43,23,102,FLAT
34,46,15,61,107,126,51,62,28,38,84,34,131,74,139,62,111,149,139,165,102,128,129,145,FLAT
-31,9,46,55,61,107,126,51,34,0,6,-31,62,38,90,3,165,74,145,31,145,149,145,134,FLAT
-92,0,94,94,89,55,61,107,-61,-61,-66,-92,-92,-105,-144,-153,-58,-105,-138,-184,-30,-67,-54,-150,FLAT
31,32,14,46,94,89,55,61,-92,-49,-1,31,-153,-110,-67,-61,-184,-154,-145,-122,-150,-154,-139,-153,FLAT
-36,9,56,65,46,94,89,55,31,6,-13,-36,-61,-43,-14,-5,-122,-104,-80,-97,-153,-148,-158,-158,FLAT
-38,2,40,42,65,46,94,89,-36,-54,-31,-38,-5,-48,-44,-74,-97,-97,-45,-43,-158,-158,-111,-135,FLAT
-57,1,81,82,42,65,46,94,-38,-16,-56,-57,-74,-70,-87,-95,-43,-64,-100,-131,-135,-113,-101,-100,FLAT
34,35,17,52,82,42,65,46,-57,-30,0,34,-95,-46,-56,-23,-131,-100,-87,-61,-100,-94,-100,-97,FLAT
26,61,1,62,52,82,42,65,34,10,0,26,-23,-20,0,60,-61,-36,-56,3,-97,-90,-87,-35,FLAT
-29,6,71,77,62,52,82,42,26,41,26,-29,60,51,26,-3,3,21,26,31,-35,5,-30,-26,FLAT
65,67,34,101,77,62,52,82,-29,28,4,65,-3,69,30,36,31,79,30,62,-26,49,30,96,FLAT
-51,4,94,98,101,77,62,52,65,9,12,-51,36,37,16,14,62,78,42,-15,96,88,42,11,FLAT
9,66,36,102,98,101,77,62,-51,-49,-53,9,14,-40,-41,-42,-15,-12,-37,23,11,29,-11,-6,FLAT
16,83,24,107,102,98,101,77,9,4,-1,16,-42,-45,-54,25,23,-36,-42,-26,-6,-8,-38,39,FLAT
20,40,14,54,107,102,98,101,16,10,63,20,25,14,62,36,-26,-35,9,45,39,-26,21,-6,FLAT
-54,0,77,77,54,107,102,98,20,9,-14,-54,36,19,49,-34,45,23,48,-18,-6,-26,-5,-9,FLAT
60,66,49,115,77,54,107,102,-54,32,-6,60,-34,41,-20,6,-18,51,43,26,-9,55,42,42,FLAT
-62,2,82,84,115,77,54,107,60,-29,2,-62,6,3,-4,-2,26,12,-18,-56,42,22,45,-36,FLAT
-206,27,214,241,84,115,77,54,-62,-74,-231,-206,-2,-103,-229,-268,-56,-71,-235,-208,-36,-62,-249,-262,FLAT
-39,11,88,99,241,84,115,77,-206,-165,-23,-39,-268,-239,-254,-245,-208,-268,-252,-307,-262,-236,-258,-247,FLAT
-15,48,50,98,99,241,84,115,-39,-53,-52,-15,-245,-218,-75,-54,-307,-292,-306,-260,-247,-321,-304,-322,FLAT
32,165,3,168,98,99,241,84,-15,-15,-85,32,-54,-68,-137,17,-260,-233,-160,-22,-322,-307,-391,-228,FLAT
58,69,17,86,168,98,99,241,32,72,154,58,17,57,69,90,-22,4,17,75,-228,-161,-6,36,FLAT
15,31,5,36,86,168,98,99,58,3,53,15,90,75,207,73,75,60,122,105,36,7,70,90,FLAT
-38,32,50,82,36,86,168,98,15,7,-39,-38,73,10,14,-23,105,82,168,35,90,67,83,67,FLAT
-3,7,55,62,82,36,86,168,-38,2,22,-3,-23,9,-17,-41,35,12,36,-26,67,84,190,32,FLAT
-77,25,88,113,62,82,36,86,-3,-44,-95,-77,-41,-42,-73,-80,-26,-35,-112,-118,32,-32,-59,-103,FLAT
-38,23,39,62,113,62,82,36,-77,-87,-36,-38,-80,-131,-131,-115,-118,-129,-109,-118,-103,-122,-148,-156,FLAT
-4,31,28,59,110,62,113,62,101,15,66,-4,63,86,89,97,-14,-1,53,59,-17,-45,-42,-18,FLAT
24,44,6,50,59,110,62,113,-4,2,11,24,97,17,77,20,59,88,100,121,-18,1,64,83,FLAT
-24,20,30,50,50,59,110,62,24,0,0,-24,20,2,11,0,121,17,77,-4,83,88,100,97,FLAT
56,62,3,65,50,50,59,110,-24,29,14,56,0,29,14,32,-4,31,25,56,97,46,91,52,FLAT
14,21,5,26,65,50,50,59,56,16,55,14,32,45,69,70,56,45,69,46,52,47,80,70,FLAT
2,15,9,24,22,47,69,53,1,10,8,2,27,-5,18,3,5,12,57,29,25,3,32,7,FLAT
-10,8,19,27,24,22,47,69,2,0,-3,-10,3,10,5,-8,29,-5,15,-7,7,12,54,19,FLAT
-15,33,15,48,27,24,22,47,-10,-19,-40,-15,-8,-19,-43,-25,-7,-9,-35,-23,19,-24,-25,-22,FLAT
-2,26,2,28,48,27,24,22,-15,-15,5,-2,-25,-34,-35,-17,-23,-34,-38,-27,-22,-24,-30,-25,FLAT
-19,7,19,26,28,48,27,24,-2,-2,0,-19,-17,-17,5,-21,-27,-36,-35,-36,-25,-36,-38,-46,FLAT
-7,17,26,43,26,28,48,27,-19,0,-17,-7,-21,-2,-17,-26,-36,-17,-12,-28,-46,-36,-52,-43,FLAT
-10,1,36,37,43,26,28,48,-7,0,6,-10,-26,0,-11,-17,-28,-2,-11,-36,-43,-17,-6,-38,FLAT
-51,4,52,56,37,43,26,28,-10,-35,-54,-51,-17,-35,-48,-61,-36,-35,-65,-68,-38,-37,-65,-87,FLAT
26,37,17,54,56,37,43,26,-51,-9,-7,26,-61,-44,-61,-25,-68,-44,-55,-35,-87,-44,-72,-42,FLAT
-79,10,91,101,54,56,37,43,26,-5,-52,-79,-25,-14,-59,-53,-35,-49,-113,-104,-42,-49,-107,-114,FLAT
28,64,11,75,101,54,56,37,-79,-52,-26,28,-53,-57,-78,-51,-104,-66,-85,-25,-114,-101,-139,-76,FLAT
-20,17,64,81,75,101,54,56,28,33,27,-20,-51,-19,1,8,-25,-24,-51,-71,-76,-33,-58,-45,FLAT
8,24,3,27,81,75,101,54,-20,-53,1,8,8,-20,28,-12,-71,-72,2,16,-45,-77,-50,-63,FLAT
65,90,20,110,27,81,75,101,8,82,-1,65,-12,29,0,73,16,62,27,53,-63,10,1,81,FLAT
-28,10,65,75,110,27,81,75,65,17,52,-28,73,99,51,37,53,46,52,45,81,79,79,25,FLAT
-127,35,172,207,75,110,27,81,-28,-20,-152,-127,37,-3,-100,-155,45,79,-101,-90,25,26,-100,-82,FLAT
38,76,2,78,207,75,110,27,-127,-132,-3,38,-155,-152,-155,-89,-90,-135,-103,-117,-82,-53,-104,-52,FLAT
57,63,5,68,78,207,75,110,38,60,70,57,-89,-72,67,95,-117,-92,-85,-32,-52,-75,-33,-60,FLAT
-48,10,71,81,68,78,207,75,57,18,5,-48,95,78,75,9,-32,-54,72,47,-60,-74,-80,-80,FLAT
-34,20,61,81,81,68,78,207,-48,-44,-44,-34,9,-26,-39,-82,47,34,31,-25,-80,-98,28,13,FLAT
53,71,16,87,81,81,68,78,-34,8,2,53,-82,-36,-42,19,-25,-18,-37,-29,13,42,33,28,FLAT
0,34,18,52,87,81,81,68,53,2,37,0,19,10,39,53,-29,-34,-5,19,28,-16,0,-29,FLAT
20,22,21,43,52,87,81,81,0,23,32,20,53,25,69,20,19,33,71,73,-29,-11,27,39,FLAT
6,9,33,42,43,52,87,81,20,18,19,6,20,41,51,26,73,43,88,26,39,51,90,79,FLAT
11,12,23,35,42,43,52,87,6,1,8,11,26,19,27,17,26,42,59,37,79,44,96,37,FLAT
-36,46,43,89,35,42,43,52,11,-16,-70,-36,17,-15,-62,-25,37,3,-43,-19,37,26,-11,1,FLAT
24,24,17,41,89,35,42,43,-36,-2,46,24,-25,-18,-24,-12,-19,-17,-16,-1,1,1,3,5,FLAT
18,32,42,74,41,89,35,42,24,43,10,18,-12,41,56,42,-1,25,-14,6,5,26,-6,17,FLAT
-86,25,86,111,74,41,89,35,18,-42,-79,-86,42,1,-69,-68,6,-1,-23,-44,17,-17,-93,-80,FLAT
-39,0,54,54,111,74,41,89,-86,-71,-14,-39,-68,-113,-93,-125,-44,-70,-83,-107,-80,-72,-37,-83,FLAT
37,53,12,65,54,111,74,41,-39,-5,-16,37,-125,-76,-30,-2,-107,-118,-109,-88,-83,-75,-99,-70,FLAT
46,54,38,92,65,54,111,74,37,72,45,46,-2,67,29,83,-88,-4,15,44,-70,-46,-64,-42,FLAT
-13,21,55,76,92,65,54,111,46,4,20,-13,83,76,65,33,44,71,49,70,-42,0,35,31,FLAT
-105,33,105,138,76,92,65,54,-13,-55,-117,-105,33,-51,-97,-118,70,21,-52,-72,31,16,-68,-35,FLAT
-15,41,43,84,138,76,92,65,-105,-77,-23,-15,-118,-132,-140,-120,-72,-128,-120,-133,-35,-56,-75,-87,FLAT
-158,24,158,182,84,138,76,92,-15,-43,-141,-158,-120,-120,-164,-173,-133,-175,-281,-278,-87,-171,-261,-291,FLAT
32,45,36,81,182,84,138,76,-158,-90,11,32,-173,-133,-130,-126,-278,-210,-153,-141,-291,-265,-270,-246,FLAT
-65,40,94,134,81,182,84,138,32,-7,-60,-65,-126,-97,-49,-33,-141,-140,-190,-191,-246,-217,-213,-206,FLAT
102,103,7,110,134,81,182,84,-65,15,39,102,-33,8,-21,37,-191,-82,-10,69,-206,-125,-151,-89,FLAT
-64,11,82,93,110,134,81,182,102,11,28,-64,37,26,67,38,69,19,7,-27,-89,-71,18,5,FLAT
36,42,17,59,93,110,134,81,-64,-29,5,36,38,-18,33,-28,-27,-3,72,74,5,-10,12,9,FLAT
-172,19,225,244,59,93,110,134,36,36,-149,-172,-28,7,-144,-136,74,18,-116,-200,9,33,-77,-98,FLAT
-176,0,190,190,244,59,93,110,-172,-211,-157,-176,-136,-175,-306,-348,-200,-204,-301,-312,-98,-193,-273,-376,FLAT
-54,28,70,98,190,244,59,93,-176,-174,-82,-54,-348,-385,-239,-230,-312,-349,-388,-402,-376,-378,-383,-366,FLAT
36,56,9,65,98,190,244,59,-54,-25,8,36,-230,-199,-74,-18,-402,-410,-231,-194,-366,-374,-380,-366,FLAT
17,22,39,61,65,98,190,244,36,47,51,17,-18,22,59,53,-194,-152,-23,-1,-366,-363,-180,-177,FLAT
-62,8,70,78,61,65,98,190,17,-31,-48,-62,53,16,3,-45,-1,-9,11,-9,-177,-183,-71,-63,FLAT
-63,9,69,78,78,61,65,98,-62,-64,-64,-63,-45,-95,-112,-125,-9,-48,-61,-108,-63,-73,-53,-72,FLAT
-12,30,23,53,78,78,61,65,-63,-58,-33,-12,-125,-122,-97,-75,-108,-153,-145,-137,-72,-106,-94,-120,FLAT
-12,3,52,55,53,78,78,61,-12,17,15,-12,-75,-41,-18,-24,-137,-105,-82,-87,-120,-136,-130,-149,FLAT
-50,20,59,79,55,53,78,78,-12,-43,-67,-50,-24,-26,-52,-62,-87,-84,-85,-74,-149,-148,-149,-137,FLAT
-85,5,91,96,79,55,53,78,-50,-53,-70,-85,-62,-96,-137,-135,-74,-79,-122,-147,-137,-137,-155,-159,FLAT
38,55,3,58,96,79,55,53,-85,-50,-12,38,-135,-103,-82,-47,-147,-146,-149,-97,-159,-129,-134,-109,FLAT
24,48,2,50,33,58,96,79,3,2,-15,24,41,26,34,27,-44,-24,22,65,-94,-77,-48,-20,FLAT
68,89,1,90,50,33,58,96,24,67,27,68,27,69,12,92,65,93,61,95,-20,43,49,133,FLAT
-33,0,46,46,90,50,33,58,68,12,56,-33,92,79,83,35,95,81,68,59,133,105,117,62,FLAT
3,17,7,24,45,18,35,36,-29,-30,-9,3,-21,-20,-26,-26,-36,-37,-26,-18,-46,-48,-36,-33,FLAT
9,27,2,29,24,45,18,35,3,4,-1,9,-26,-26,-10,12,-18,-16,-27,-17,-33,-33,-27,-9,FLAT
8,14,5,19,29,24,45,18,9,11,21,8,12,15,20,17,-17,-15,11,20,-9,-5,-6,-9,FLAT
7,12,1,13,19,29,24,45,8,3,9,7,17,14,30,15,20,18,29,24,-9,-12,20,27,FLAT
9,30,3,33,13,19,29,24,7,11,-9,9,15,14,0,16,24,25,21,24,27,29,20,33,FLAT
-5,3,25,28,33,13,19,29,9,17,22,-5,16,28,13,4,24,31,22,11,33,42,43,19,FLAT
-16,13,16,29,28,33,13,19,-5,-25,-26,-16,4,-8,-4,-21,11,3,-13,-12,19,6,-4,-5,FLAT
3,41,8,49,29,28,33,13,-16,-5,-25,3,-21,-30,-51,-13,-12,-13,-29,-18,-5,-2,-38,-9,FLAT
54,61,6,67,49,29,28,33,3,52,34,54,-13,47,9,57,-18,22,-17,41,-9,39,5,36,FLAT
-16,46,20,66,67,49,29,28,54,-2,-1,-16,57,50,33,38,41,45,8,41,36,20,-18,25,FLAT
29,55,5,60,66,67,49,29,-16,14,20,29,38,12,19,13,41,64,53,67,25,59,28,70,FLAT
-6,18,12,30,60,66,67,49,29,1,31,-6,13,15,51,23,67,13,50,7,70,65,84,61,FLAT
-14,21,26,47,76,86,30,60,-50,-55,-26,-14,-58,-47,-8,-64,-64,-58,-75,-72,-35,-57,-44,-78,FLAT
-74,35,78,113,47,76,86,30,-14,-22,-88,-74,-64,-77,-114,-88,-72,-69,-96,-138,-78,-80,-163,-146,FLAT
-14,30,40,70,113,47,76,86,-74,-52,-9,-14,-88,-74,-97,-88,-138,-129,-123,-102,-146,-121,-105,-152,FLAT
-15,13,63,76,70,113,47,76,-14,8,2,-15,-88,-44,-7,-29,-102,-66,-95,-103,-152,-121,-121,-117,FLAT
66,116,4,120,76,70,113,47,-15,7,-37,66,-29,15,-35,51,-103,-37,-44,37,-117,-59,-132,-37,FLAT
21,29,27,56,120,76,70,113,66,44,108,21,51,51,71,87,37,59,73,72,-37,7,64,58,FLAT
-67,17,67,84,56,120,76,70,21,-27,-55,-67,87,17,53,-46,72,24,16,20,58,32,18,5,FLAT
-6,5,45,50,84,56,120,76,-67,-28,6,-6,-46,-55,-49,-73,20,-11,59,-52,5,-4,22,14,FLAT
11,57,25,82,50,84,56,120,-6,-9,-41,11,-73,-37,-35,5,-52,-64,-90,-62,14,-20,18,-41,FLAT
-49,17,71,88,82,50,84,56,11,-3,-9,-49,5,-12,-50,-38,-62,-40,-44,-44,-41,-67,-99,-111,FLAT
39,48,3,51,88,82,50,84,-49,-29,8,39,-38,-32,-1,-10,-44,-41,-42,1,-111,-69,-36,-5,FLAT
-31,25,45,70,51,88,82,50,39,11,-8,-31,-10,-18,0,8,1,-21,-9,-41,-5,-30,-50,-30,FLAT
-11,35,34,69,70,51,88,82,-31,-22,-21,-11,8,-11,-29,-42,-41,-40,-21,-3,-30,-43,-30,-52,FLAT
29,44,9,53,69,70,51,88,-11,4,20,29,-42,-18,-1,18,-3,-7,-9,-13,-52,-36,-1,26,FLAT
-10,22,11,33,53,69,70,51,29,-8,12,-10,18,-4,32,19,-13,-26,11,8,26,-15,3,-23,FLAT
-17,22,35,57,33,53,69,70,-10,7,-17,-17,19,-1,-5,-27,8,3,15,2,-23,-19,-6,-9,FLAT
14,27,15,42,57,33,53,69,-17,-6,9,14,-27,1,-8,-3,2,-7,4,-13,-9,-3,24,16,FLAT
57,67,4,71,42,57,33,53,14,46,17,57,-3,40,26,71,-13,47,9,54,16,39,21,44,FLAT
-128,10,128,138,71,42,57,33,57,-4,-71,-128,71,42,-54,-71,54,36,-45,-57,44,43,-62,-74,FLAT
66,66,16,82,138,71,42,57,-128,-46,10,66,-71,-50,-61,-62,-57,-4,-44,-5,-74,-10,-35,9,FLAT
-26,26,79,105,82,138,71,42,66,37,14,-26,-62,-9,24,40,-5,-13,-47,-88,9,33,-30,-31,FLAT
24,32,31,63,105,82,138,71,-26,-24,18,24,40,13,32,-2,-88,-33,42,64,-31,-37,-29,-64,FLAT
37,43,61,104,63,105,82,138,24,67,26,37,-2,43,44,61,64,80,58,35,-64,34,68,101,FLAT
36,50,33,83,104,63,105,82,37,8,29,36,61,75,55,73,35,51,73,97,101,88,87,71,FLAT
3,19,59,78,83,104,63,105,36,29,34,3,73,37,63,39,97,104,89,76,71,80,107,100,FLAT
-74,71,86,157,96,78,83,104,-60,-80,-141,-74,-57,-107,-186,-134,-21,-78,-152,-131,16,-70,-123,-95,FLAT
-51,46,51,97,157,96,78,83,-74,-86,-26,-51,-134,-166,-167,-125,-131,-193,-212,-185,-95,-164,-178,-182,FLAT
17,51,6,57,97,157,96,78,-51,-28,12,17,-125,-114,-14,-34,-185,-194,-155,-108,-182,-221,-200,-168,FLAT
-9,18,34,52,57,97,157,96,17,19,24,-9,-34,-9,36,8,-108,-95,10,-43,-168,-175,-131,-117,FLAT
-12,54,20,74,52,57,97,157,-9,-26,-48,-12,8,-7,-24,-21,-43,-35,-12,-4,-117,-121,-38,-55,FLAT
105,116,2,118,74,52,57,97,-12,87,43,105,-21,61,-5,93,-4,80,19,84,-55,52,31,101,FLAT
-29,13,52,65,118,74,52,57,105,21,74,-29,93,108,117,76,84,82,69,64,101,101,93,55,FLAT
-41,16,52,68,65,118,74,52,-29,-41,-44,-41,76,-20,30,-70,64,67,73,35,55,41,25,23,FLAT
28,35,44,79,68,65,118,74,-41,20,9,28,-70,-21,-35,-13,35,0,39,-42,23,87,82,63,FLAT
-34,7,55,62,79,68,65,118,28,-23,-6,-34,-13,-3,3,-6,-42,-44,-41,-47,63,-23,33,-76,FLAT
37,43,14,57,62,79,68,65,-34,-4,1,37,-6,-27,-5,3,-47,-7,4,31,-76,-48,-40,-10,FLAT
-11,9,14,23,57,62,79,68,37,-11,23,-11,3,-15,24,26,31,-38,18,-8,-10,-18,27,20,FLAT
46,53,21,74,23,57,62,79,-11,53,2,46,26,42,25,35,-8,38,26,72,20,15,20,38,FLAT
24,30,6,36,74,23,57,62,46,9,47,24,35,62,49,70,72,51,72,59,38,47,73,96,FLAT
-1,25,10,35,36,74,23,57,24,3,4,-1,70,12,51,23,59,65,53,69,96,54,76,58,FLAT
32,47,1,48,35,36,74,23,-1,23,10,32,23,26,14,31,69,35,61,55,58,88,63,101,FLAT
-29,11,30,41,48,35,36,74,32,0,7,-29,31,23,17,3,55,26,21,2,101,35,68,26,FLAT
-4,7,8,15,21,31,34,47,-16,-12,-6,-4,-9,-20,-4,-20,-5,-28,-9,-13,-39,-35,-3,-9,FLAT
-21,15,22,37,15,21,31,34,-4,-7,-29,-21,-20,-19,-35,-25,-13,-27,-33,-41,-9,-35,-38,-34,FLAT
-30,0,31,31,37,15,21,31,-21,-21,-15,-30,-25,-28,-44,-51,-41,-40,-50,-55,-34,-48,-48,-71,FLAT
-26,1,26,27,31,37,15,21,-30,-31,-27,-26,-51,-52,-42,-56,-55,-59,-71,-77,-71,-71,-77,-81,FLAT
24,33,2,35,27,31,37,15,-26,0,-8,24,-56,-31,-35,-2,-77,-52,-50,-32,-81,-59,-79,-53,FLAT
-48,3,49,52,63,35,27,31,56,-3,8,-48,80,55,38,8,54,55,30,32,24,24,3,6,FLAT
14,37,3,40,52,63,35,27,-48,-32,-20,14,8,-35,-12,-34,32,23,18,22,6,23,10,46,FLAT
94,101,6,107,40,52,63,35,14,97,30,94,-34,65,10,108,22,62,18,60,46,120,48,116,FLAT
-53,14,53,67,107,40,52,63,94,-6,34,-53,108,91,64,41,60,59,44,55,116,56,52,7,FLAT
30,50,21,71,67,107,40,52,-53,-2,-6,30,41,-8,28,-23,55,89,58,71,7,57,38,85,FLAT
5,32,4,36,71,67,107,40,30,-12,23,5,-23,-14,17,35,71,-20,51,-18,85,77,81,76,FLAT
59,59,53,112,36,71,67,107,5,108,32,59,35,96,55,64,-18,94,49,94,76,88,83,41,FLAT
91,107,19,126,112,36,71,67,59,57,43,91,64,165,75,150,94,153,98,155,41,151,92,185,FLAT
-460,44,461,505,248,126,112,36,-201,-200,-457,-460,-110,-219,-598,-661,-51,-162,-555,-570,-46,-54,-523,-511,FLAT
21,56,63,119,505,248,126,112,-460,-377,9,21,-661,-577,-448,-439,-570,-596,-589,-640,-511,-539,-546,-549,FLAT
-27,34,96,130,119,505,248,126,21,6,-5,-27,-439,-371,4,-6,-640,-571,-453,-466,-549,-590,-594,-667,FLAT
18,42,38,80,130,119,505,248,-27,-40,10,18,-6,-34,5,-9,-466,-411,14,12,-667,-611,-443,-448,FLAT
-71,74,104,178,80,130,119,505,18,-5,-103,-71,-9,-45,-93,-53,12,-39,-98,-80,-448,-416,-89,-59,FLAT
-21,17,74,91,178,80,130,119,-71,-51,36,-21,-53,-56,-67,-92,-80,-96,-57,-74,-59,-90,-62,-101,FLAT
48,53,40,93,140,91,178,80,114,78,125,48,93,128,126,162,22,77,162,141,40,72,59,70,FLAT
9,27,41,68,93,140,91,178,48,10,35,9,162,88,160,57,141,138,161,171,70,87,197,150,FLAT
-62,18,62,80,68,93,140,91,9,-41,-53,-62,57,-31,-18,-53,171,47,107,-5,150,97,108,109,FLAT
10,27,25,52,80,68,93,140,-62,-27,1,10,-53,-68,-52,-52,-5,-58,-17,-43,109,20,108,5,FLAT
-11,9,63,72,52,80,68,93,10,27,7,-11,-52,0,8,-1,-43,-41,-45,-63,5,-31,-10,-54,FLAT
80,91,2,93,72,52,80,68,-11,19,-2,80,-1,46,5,69,-63,19,6,79,-54,-22,-47,17,FLAT
18,27,19,46,93,72,52,80,80,35,82,18,69,54,80,98,79,81,87,87,17,54,88,97,FLAT
58,96,10,106,46,93,72,52,18,49,-11,58,98,84,71,76,87,103,69,156,97,130,76,145,FLAT
35,78,13,91,106,46,93,72,58,38,53,35,76,87,42,93,156,122,124,111,145,141,122,191,FLAT
65,81,19,100,91,106,46,93,35,71,62,65,93,109,115,100,111,158,104,158,191,193,186,176,FLAT
-36,11,60,71,104,100,91,106,-100,-76,-43,-36,-35,-95,-66,-136,0,-24,-4,-71,58,14,49,-36,FLAT
-54,13,55,68,71,104,100,91,-36,-59,-56,-54,-136,-135,-99,-90,-71,-154,-122,-190,-36,-83,-60,-125,FLAT
-35,13,89,102,68,71,104,100,-54,-1,-35,-35,-90,-60,-91,-89,-190,-136,-134,-125,-125,-155,-157,-225,FLAT
29,53,6,59,102,68,71,104,-35,-54,-11,29,-89,-55,-46,-6,-125,-114,-102,-60,-225,-190,-145,-96,FLAT
-57,0,77,77,59,102,68,71,29,14,-4,-57,-6,-40,-15,-28,-60,-41,-50,-63,-96,-100,-106,-117,FLAT
-20,56,26,82,77,59,102,68,-57,-71,-76,-20,-28,-57,-80,-77,-63,-111,-91,-48,-117,-112,-126,-83,FLAT
141,149,27,176,82,77,59,102,-20,142,48,141,-77,71,-28,121,-48,85,-32,64,-83,31,-43,93,FLAT
-93,55,199,254,176,82,77,59,141,79,1,-93,121,221,49,48,64,150,-27,28,93,164,-31,-29,FLAT
-1,30,62,92,254,176,82,77,-93,-138,24,-1,48,-59,25,-94,28,83,73,47,-29,12,-3,27,FLAT
-143,14,146,160,92,254,176,82,-1,-59,-127,-143,-94,-197,-103,-144,47,-118,-102,-237,27,24,-54,-96,FLAT
147,159,26,185,160,92,254,176,-143,27,2,147,-144,-32,-125,4,-237,-170,-101,3,-96,-91,-100,-90,FLAT
-59,31,69,100,185,160,92,254,147,-16,69,-59,4,11,71,88,3,-48,-56,-55,-90,-186,-32,-56,FLAT
-35,26,51,77,100,185,160,92,-59,-53,-30,-35,88,-69,39,-94,-55,-42,41,53,-56,-101,-86,-90,FLAT
-16,31,50,81,77,100,185,160,-35,-17,-21,-16,-94,-70,-51,-51,53,-86,18,-110,-90,-59,20,37,FLAT
-8,3,66,69,81,77,100,185,-16,8,20,-8,-51,-9,-1,-24,-110,-62,-31,-59,37,-78,38,-118,FLAT
88,99,20,119,69,81,77,100,-8,42,-8,88,-24,50,12,80,-59,33,-9,64,-118,-20,-39,29,FLAT
-36,69,47,116,119,69,81,77,88,-9,-6,-36,80,33,-14,52,64,41,6,44,29,24,-15,28,FLAT
1,21,14,35,116,119,69,81,-36,-32,49,1,52,-41,43,-35,44,1,35,53,28,9,55,45,FLAT
5,25,36,61,35,116,119,69,1,27,1,5,-35,-5,50,6,53,-14,44,-30,45,28,36,58,FLAT
23,40,11,51,61,35,116,119,5,-2,8,23,6,25,9,28,-30,-7,58,29,58,-16,52,-7,FLAT
7,38,20,58,51,61,35,116,23,16,9,7,28,14,17,30,29,41,18,35,-7,9,67,36,FLAT
-47,11,70,81,58,51,61,35,7,3,-20,-47,30,19,-11,-40,35,17,-3,-17,36,44,-2,-12,FLAT
-35,53,35,88,81,58,51,61,-47,-70,-77,-35,-40,-67,-97,-82,-17,-51,-88,-75,-12,-53,-80,-52,FLAT
9,20,3,23,88,81,58,51,-35,-23,42,9,-82,-93,-35,-26,-75,-90,-55,-73,-52,-74,-46,-66,FLAT
5,9,13,22,27,42,30,59,11,12,17,5,-16,-11,9,16,-29,-13,-5,-11,13,-21,16,-24,FLAT
0,14,8,22,22,27,42,30,5,-5,-5,0,16,7,12,5,-11,-16,4,16,-24,-18,-10,-11,FLAT
-15,5,18,23,22,22,27,42,0,-5,-6,-15,5,-10,-11,-15,16,2,6,-10,-11,-21,-2,1,FLAT
-55,7,56,63,23,22,22,27,-15,-17,-57,-55,-15,-22,-63,-70,-10,-27,-68,-70,1,-15,-51,-65,FLAT
-10,16,10,26,63,23,22,22,-55,-56,-19,-10,-70,-73,-76,-65,-70,-78,-82,-80,-65,-83,-87,-80,FLAT
16,23,7,30,37,26,63,23,25,20,27,16,15,38,34,41,-40,-18,15,31,-55,-35,-42,-24,FLAT
19,28,14,42,30,37,26,63,16,26,14,19,41,46,41,35,31,64,48,60,-24,8,29,50,FLAT
-1,55,20,75,42,30,37,26,19,5,-28,-1,35,31,-14,18,60,51,13,34,50,69,20,59,FLAT
16,61,22,83,75,42,30,37,-1,18,10,16,18,23,-18,15,34,49,-4,34,59,69,23,50,FLAT
57,61,6,67,83,75,42,30,16,41,57,57,15,59,67,73,34,64,39,72,50,90,53,91,FLAT
-24,2,58,60,67,83,75,42,57,28,35,-24,73,69,92,33,72,87,102,49,91,92,74,48,FLAT
26,109,5,114,65,60,67,83,-13,-24,-73,26,-37,-40,-94,13,20,-12,-59,-11,36,29,-2,46,FLAT
-21,11,38,49,114,65,60,67,26,12,77,-21,13,-12,4,5,-11,-28,-17,-8,46,0,18,-32,FLAT
-15,34,58,92,49,114,65,60,-21,5,-38,-15,5,17,39,-36,-8,-7,-34,-10,-32,-23,-55,-23,FLAT
-75,15,108,123,92,49,114,65,-15,-25,-56,-75,-36,-20,-94,-90,-10,-8,-17,-111,-23,-32,-90,-85,FLAT
-115,63,115,178,123,92,49,114,-75,-108,-163,-115,-90,-133,-219,-190,-111,-128,-257,-205,-85,-116,-180,-226,FLAT
36,106,12,118,178,123,92,49,-115,-67,-7,36,-190,-175,-170,-79,-205,-200,-226,-154,-226,-195,-264,-169,FLAT
14,46,30,76,118,178,123,92,36,32,74,14,-79,-35,67,50,-154,-143,-96,-65,-169,-168,-152,-140,FLAT
0,16,55,71,76,118,178,123,14,25,30,0,50,57,104,14,-65,-10,97,50,-140,-118,-66,-65,FLAT
-41,0,69,69,71,76,118,178,0,-27,-25,-41,14,-2,5,-41,50,30,79,-27,-65,-37,72,9,FLAT
-56,9,57,66,69,71,76,118,-41,-68,-65,-56,-41,-95,-90,-97,-27,-70,-60,-97,9,-38,14,-83,FLAT
-103,16,105,121,66,69,71,76,-56,-55,-110,-103,-97,-123,-175,-159,-97,-150,-200,-200,-83,-125,-170,-200,FLAT
-24,6,49,55,121,66,69,71,-103,-80,-14,-24,-159,-135,-124,-127,-200,-203,-189,-183,-200,-230,-214,-224,FLAT
36,51,5,56,55,121,66,69,-24,-8,-9,36,-127,-88,-23,12,-183,-143,-133,-91,-224,-211,-198,-147,FLAT
-3,20,12,32,56,55,121,66,36,4,28,-3,12,-4,19,33,-91,-84,5,9,-147,-139,-105,-94,FLAT
-5,3,9,12,32,56,55,121,-3,-8,12,-5,33,-4,40,-8,9,-12,31,28,-94,-92,17,4,FLAT
-1,2,22,24,12,32,56,55,-5,12,0,-1,-8,4,12,-6,28,8,40,-9,4,0,31,27,FLAT
-25,35,35,70,24,12,32,56,-1,-12,-58,-25,-6,0,-58,-26,-9,-8,-46,-31,27,-4,-18,-34,FLAT
12,44,29,73,70,24,12,32,-25,6,3,12,-26,-6,-55,-13,-31,6,-55,-14,-34,-2,-43,-19,FLAT
37,43,3,46,73,70,24,12,12,11,38,37,-13,17,41,49,-14,5,-17,24,-19,17,-17,23,FLAT
20,34,7,41,46,73,70,24,37,24,29,20,49,35,67,57,24,41,70,69,23,29,12,44,FLAT
21,32,5,37,41,46,73,70,20,19,23,21,57,43,52,41,69,54,90,78,44,60,93,90,FLAT
-5,26,20,46,37,41,46,73,21,10,1,-5,41,29,24,16,78,53,53,36,90,64,91,73,FLAT
-33,55,35,90,46,37,41,46,-5,-18,-62,-33,16,-8,-61,-38,36,11,-38,-17,73,35,-9,3,FLAT
6,38,21,59,90,46,37,41,-33,-8,23,6,-38,-26,-39,-27,-17,-16,-38,-32,3,3,-15,-11,FLAT
-195,2,210,212,59,90,46,37,6,-6,-159,-195,-27,-14,-136,-189,-32,-32,-198,-222,-11,-22,-197,-227,FLAT
-17,16,75,91,212,59,90,46,-195,-152,-31,-17,-189,-158,-190,-212,-222,-166,-167,-206,-227,-184,-229,-239,FLAT
128,140,5,145,91,212,59,90,-17,58,4,128,-212,-94,-27,111,-206,-100,-186,-84,-239,-108,-163,-78,FLAT
-16,41,32,73,145,91,212,59,128,11,83,-16,111,69,87,112,-84,-83,56,95,-78,-89,-103,-100,FLAT
-21,96,21,117,73,145,91,212,-16,-32,-76,-21,112,-21,7,-37,95,37,11,91,-100,-115,-20,74,FLAT
-67,14,99,113,117,73,145,91,-21,11,15,-67,-37,-21,-61,-88,91,-10,22,-104,74,48,26,24,FLAT
5,94,23,117,113,117,73,145,-67,-71,-75,5,-88,-60,-60,-62,-104,-92,-136,-83,24,-81,-53,-99,FLAT
16,23,31,54,175,117,113,117,143,42,163,16,148,167,230,159,81,96,155,164,60,107,170,97,FLAT
27,65,14,79,54,175,117,113,16,10,-15,27,159,52,148,43,164,177,215,186,97,106,140,191,FLAT
40,70,6,76,79,54,175,117,27,32,35,40,43,42,20,67,186,84,183,83,191,209,250,226,FLAT
-35,15,39,54,76,79,54,175,40,-2,20,-35,67,30,55,5,83,40,40,32,226,82,203,48,FLAT
28,37,26,63,54,76,79,54,-35,15,6,28,5,13,26,-7,32,45,61,33,48,55,46,60,FLAT
-86,13,86,99,32,62,63,54,15,-5,-72,-86,-12,-38,-75,-71,16,-38,-74,-98,-19,-23,-68,-70,FLAT
-36,1,36,37,99,32,62,63,-86,-86,-24,-36,-71,-91,-96,-122,-98,-124,-99,-107,-70,-124,-98,-134,FLAT
8,41,0,41,37,99,32,62,-36,-28,-32,8,-122,-114,-56,-28,-107,-119,-128,-114,-134,-152,-131,-99,FLAT
11,32,2,34,41,37,99,32,8,13,20,11,-28,-15,-12,19,-114,-101,-36,-17,-99,-106,-108,-103,FLAT
-10,7,23,30,34,41,37,99,11,11,15,-10,19,24,35,1,-17,-4,3,9,-103,-90,-21,-27,FLAT
6,16,6,22,47,19,27,27,29,-5,20,6,20,32,29,35,30,24,29,26,38,36,41,36,FLAT
10,14,7,21,22,47,19,27,6,11,12,10,35,6,32,16,26,43,41,45,36,35,41,36,FLAT
26,26,1,27,21,22,47,19,10,20,14,26,16,31,26,36,45,26,46,42,36,63,55,71,FLAT
-21,1,21,22,27,21,22,47,26,-1,4,-21,36,19,18,5,42,30,30,15,71,25,50,21,FLAT
-28,17,28,45,22,27,21,22,-21,-21,-44,-28,5,-22,-40,-49,15,-2,-26,-23,21,9,-14,-13,FLAT
22,28,3,31,45,22,27,21,-28,-3,11,22,-49,-24,-33,-6,-23,-25,-29,-27,-13,-5,-15,-1,FLAT
8,18,7,25,31,45,22,27,22,12,18,8,-6,9,29,30,-27,-12,-15,2,-1,-13,-11,-19,FLAT
63,72,16,88,25,31,45,22,8,72,9,63,30,84,27,71,2,81,38,93,-19,60,-6,65,FLAT
46,47,10,57,88,25,31,45,63,40,71,46,71,112,80,109,93,124,98,117,65,121,109,139,FLAT
17,71,2,73,57,88,25,31,46,9,-7,17,109,49,64,63,117,121,73,126,139,133,91,134,FLAT
61,61,6,67,73,57,88,25,17,65,71,61,63,74,64,78,126,114,135,124,134,186,144,187,FLAT
-64,9,77,86,67,73,57,88,61,7,-12,-64,78,72,59,-3,124,81,52,14,187,121,123,60,FLAT
0,19,33,52,86,67,73,57,-64,-44,-10,0,-3,-37,-22,-64,14,28,49,-3,60,37,42,14,FLAT
0,33,61,94,52,86,67,73,0,28,-14,0,-64,-16,-24,0,-3,-9,-36,-64,14,56,35,-3,FLAT
-18,46,25,71,94,52,86,67,0,-54,-31,-18,0,-26,-45,-18,-64,-70,-55,-18,-3,-63,-67,-82,FLAT
36,45,19,64,71,94,52,86,-18,30,37,36,-18,-24,6,18,-18,4,-8,18,-82,-40,-18,18,FLAT
43,44,53,97,64,71,94,52,36,77,44,43,18,107,81,79,18,53,50,61,18,81,36,61,FLAT
4,28,16,44,97,64,71,94,43,-33,20,4,79,44,64,47,61,74,101,83,61,20,70,65,FLAT
-5,18,27,45,44,97,64,71,4,6,5,-5,47,-27,25,-1,83,50,69,42,65,80,106,78,FLAT
42,73,39,112,45,44,97,64,-5,54,-13,42,-1,60,-8,37,42,27,12,41,78,104,56,84,FLAT
20,44,18,62,112,45,44,97,42,-1,49,20,37,53,36,62,41,59,41,57,84,26,61,61,FLAT
-34,1,52,53,62,112,45,44,20,0,9,-34,62,-1,58,-14,57,53,45,28,61,59,50,23,FLAT
43,52,11,63,53,62,112,45,-34,2,-8,43,-14,2,1,9,28,1,50,29,23,55,37,71,FLAT
-70,9,70,79,63,53,62,112,43,-11,-27,-70,9,-9,-35,-27,29,-9,-26,-61,71,-10,23,-41,FLAT
53,53,24,77,79,63,53,62,-70,7,9,53,-27,-4,-18,-17,-61,-2,-26,26,-41,-2,-17,-8,FLAT
0,9,26,35,77,79,63,53,53,2,44,0,-17,9,53,53,26,-2,26,-17,-8,0,18,26,FLAT
42,58,5,63,35,77,79,63,0,21,-7,42,53,23,37,42,-17,30,46,95,26,19,19,25,FLAT
16,23,43,66,63,35,77,79,42,54,51,16,42,75,44,58,95,77,88,58,25,84,97,111,FLAT
13,25,43,68,66,63,35,77,16,13,11,13,58,67,62,29,58,88,55,71,111,90,99,71,FLAT
16,56,2,58,68,66,63,35,13,-25,-15,16,29,-12,-4,29,71,42,47,45,71,63,40,87,FLAT
-34,16,67,83,124,58,68,66,-114,-83,-42,-34,-98,-83,-108,-148,-85,-108,-123,-132,-69,-95,-112,-119,FLAT
-60,28,62,90,83,124,58,68,-34,-65,-72,-60,-148,-148,-114,-94,-132,-148,-180,-208,-119,-173,-195,-192,FLAT
-29,17,29,46,90,83,124,58,-60,-62,-18,-29,-94,-127,-90,-89,-208,-210,-132,-123,-192,-210,-198,-237,FLAT
36,60,8,68,46,90,83,124,-29,15,-7,36,-89,-47,-25,7,-123,-112,-97,-53,-237,-195,-139,-87,FLAT
30,33,26,59,51,68,46,90,17,38,30,30,53,65,74,47,24,80,67,83,-36,18,49,54,FLAT
-39,9,50,59,59,51,68,46,30,-15,-15,-39,47,23,15,-9,83,50,59,8,54,65,52,44,FLAT
38,41,21,62,59,59,51,68,-39,9,6,38,-9,-6,-9,-1,8,32,21,29,44,59,65,46,FLAT
-27,14,79,93,62,59,59,51,38,31,0,-27,-1,40,6,11,29,25,-9,-28,46,63,21,2,FLAT
-1,76,5,81,93,62,59,59,-27,-75,-63,-1,11,-44,-63,-28,-28,-35,-57,10,2,-50,-72,-29,FLAT
-10,41,53,94,81,93,62,59,-1,38,25,-10,-28,-37,-38,-11,10,-6,-38,-38,-29,3,-32,0,FLAT
9,74,6,80,94,81,93,62,-10,-38,-24,9,-11,0,1,-1,-38,-75,-62,-2,0,-44,-62,-29,FLAT
45,80,18,98,80,94,81,93,9,57,39,45,-1,19,15,54,-2,57,40,44,-29,-18,-23,43,FLAT
-60,14,78,92,98,80,94,81,45,0,6,-60,54,57,45,-15,44,19,21,-6,43,57,46,-16,FLAT
54,74,2,76,92,98,80,94,-60,-22,-6,54,-15,-22,0,-6,-6,35,39,39,-16,-3,15,48,FLAT
32,32,44,76,76,92,98,80,54,74,74,32,-6,52,68,86,39,52,74,26,48,109,113,71,FLAT
35,52,26,78,76,76,92,98,32,17,15,35,86,91,89,67,26,69,83,121,71,69,89,61,FLAT
9,18,31,49,78,76,76,92,35,14,43,9,67,31,58,44,121,105,132,76,61,83,126,130,FLAT
22,38,10,48,49,78,76,76,9,1,2,22,44,15,45,31,76,32,60,66,130,106,134,98,FLAT
-37,3,72,75,48,49,78,76,22,25,-2,-37,31,26,0,-15,66,40,43,-6,98,57,58,29,FLAT
-24,20,30,50,75,48,49,78,-37,-66,-41,-24,-15,-41,-43,-61,-6,-40,-41,-39,29,-26,2,-30,FLAT
-9,35,9,44,50,75,48,49,-24,-30,-24,-9,-61,-96,-65,-33,-39,-71,-67,-70,-30,-70,-65,-48,FLAT
-82,3,82,85,44,50,75,48,-9,-9,-50,-82,-33,-39,-74,-91,-70,-105,-115,-115,-48,-80,-117,-152,FLAT
0,5,23,28,85,44,50,75,-82,-59,-2,0,-91,-68,-52,-82,-115,-98,-76,-91,-152,-164,-117,-115,FLAT
20,31,1,32,28,85,44,50,0,-2,-6,20,-82,-61,-8,20,-91,-70,-58,-62,-115,-100,-82,-71,FLAT
-77,3,86,89,32,28,85,44,20,8,-49,-77,20,6,-55,-57,-62,-53,-57,-57,-71,-62,-107,-139,FLAT
-26,14,35,49,35,42,55,96,-29,-21,-35,-26,-10,-26,-33,-55,35,-4,2,-36,-47,-51,-4,9,FLAT
26,34,2,36,49,35,42,55,-26,-7,6,26,-55,-28,-29,0,-36,-33,-27,-29,9,-11,8,-10,FLAT
9,22,15,37,36,49,35,42,26,22,21,9,0,15,27,35,-29,-6,-8,9,-10,-11,-6,-20,FLAT
0,15,21,36,37,36,49,35,9,6,7,0,35,28,28,9,9,21,34,35,-20,0,-1,9,FLAT
-76,1,117,118,36,37,36,49,0,20,-62,-76,9,26,-55,-76,35,48,-34,-67,9,41,-28,-41,FLAT
15,35,2,37,118,36,37,36,-76,-100,-19,15,-76,-80,-81,-61,-67,-74,-74,-61,-41,-52,-53,-52,FLAT
-52,3,59,62,37,118,36,37,15,5,-20,-52,-61,-95,-39,-37,-61,-75,-101,-113,-52,-69,-94,-113,FLAT
44,62,5,67,62,37,118,36,-52,-10,-15,44,-37,-5,-35,-8,-113,-105,-54,7,-113,-85,-116,-69,FLAT
-79,9,106,115,67,62,37,118,44,22,-26,-79,-8,12,-41,-35,7,17,-61,-87,-69,-83,-80,-72,FLAT
53,54,11,65,115,67,62,37,-79,-42,8,53,-35,-20,-18,-26,-87,-30,-33,18,-72,-25,-53,-34,FLAT
-1,24,43,67,65,115,67,62,53,31,29,-1,-26,-11,37,52,18,11,11,-27,-34,1,-4,17,FLAT
-4,40,30,70,67,65,115,67,-1,-17,-20,-4,52,14,9,-5,-27,-28,17,48,17,-6,-9,-31,FLAT
79,96,9,105,79,70,67,65,62,85,59,79,58,120,85,141,57,103,65,137,110,134,94,136,FLAT
91,111,12,123,105,79,70,67,79,94,76,91,141,179,135,170,137,214,161,232,136,197,141,228,FLAT
124,124,6,130,123,105,79,70,91,118,111,124,170,212,187,215,232,297,246,294,228,332,272,356,FLAT
-8,19,57,76,130,123,105,79,124,43,97,-8,215,161,208,116,294,255,284,207,356,340,343,286,FLAT
-4,38,35,73,76,130,123,105,-8,-26,-23,-4,116,17,74,-12,207,135,185,112,286,229,261,203,FLAT
47,62,8,70,73,76,130,123,-4,20,23,47,-12,-6,0,43,112,37,97,35,203,155,208,159,FLAT
49,92,0,92,70,73,76,130,47,41,19,49,43,61,42,96,35,35,19,92,159,78,116,84,FLAT
13,45,3,48,92,70,73,76,49,16,60,13,96,57,79,62,92,77,102,109,84,51,79,105,FLAT
1,9,50,59,48,92,70,73,13,48,37,1,62,64,97,14,109,105,116,63,105,125,139,110,FLAT
-73,12,92,104,59,48,92,70,1,-31,-76,-73,14,17,-39,-72,63,33,21,-59,110,74,40,-10,FLAT
-37,5,41,46,104,59,48,92,-73,-88,-30,-37,-72,-119,-106,-110,-59,-71,-69,-109,-10,-55,-9,-96,FLAT
116,129,6,135,46,104,59,48,-37,81,-8,116,-110,-7,-38,79,-109,-38,-114,6,-96,10,-77,7,FLAT
70,73,10,83,135,46,104,59,116,74,126,70,79,155,118,186,6,67,88,149,7,36,12,76,FLAT
-8,11,37,48,83,135,46,104,70,19,54,-8,186,93,180,62,149,174,172,178,76,86,142,141,FLAT
-57,11,59,70,68,48,83,135,-29,-59,-61,-57,-37,-64,-86,-86,33,-45,-32,-94,149,29,94,-24,FLAT
-20,43,24,67,70,68,48,83,-57,-55,-52,-20,-86,-114,-113,-77,-94,-119,-138,-106,-24,-100,-84,-114,FLAT
18,37,0,37,67,70,68,48,-20,-6,24,18,-77,-61,-28,-2,-106,-120,-89,-59,-114,-125,-114,-88,FLAT
23,59,18,77,37,67,70,68,18,41,1,23,-2,35,25,41,-59,-20,-27,21,-88,-79,-88,-36,FLAT
-9,46,21,67,77,37,67,70,23,-6,4,-9,41,35,5,14,21,29,29,32,-36,-26,-23,12,FLAT
-356,4,359,363,158,67,77,37,-94,-96,-301,-356,-103,-112,-408,-450,-80,-118,-404,-459,-62,-77,-403,-436,FLAT
-125,109,146,255,363,158,67,77,-356,-338,-230,-125,-450,-434,-531,-481,-459,-450,-638,-575,-436,-456,-634,-584,FLAT
-218,118,238,356,255,363,158,67,-125,-126,-227,-218,-481,-464,-457,-343,-575,-560,-758,-699,-584,-576,-865,-793,FLAT
-224,33,285,318,356,255,363,158,-218,-177,-139,-224,-343,-303,-366,-442,-699,-641,-596,-567,-793,-737,-897,-923,FLAT
-121,46,124,170,318,356,255,363,-224,-282,-134,-121,-442,-459,-273,-345,-567,-585,-500,-563,-923,-923,-730,-688,FLAT
-298,18,301,319,170,318,356,255,-121,-121,-270,-298,-345,-403,-404,-419,-563,-580,-543,-643,-688,-706,-770,-861,FLAT
132,167,79,246,319,170,318,356,-298,-90,-17,132,-419,-211,-287,-166,-643,-493,-421,-287,-861,-670,-560,-511,FLAT
-21,143,46,189,246,319,170,318,132,-54,3,-21,-166,-144,-14,111,-287,-265,-284,-187,-511,-547,-418,-308,FLAT
-127,11,155,166,189,246,319,170,-21,-18,5,-127,111,-72,8,-148,-187,-162,-9,-16,-308,-283,-279,-314,FLAT
-52,11,62,73,166,189,246,319,-127,-145,-52,-52,-148,-163,-47,-179,-16,-217,-44,-200,-314,-307,-61,-68,FLAT
38,82,12,94,73,166,189,246,-52,-12,-33,38,-179,-157,-85,-14,-200,-175,-80,-141,-68,-229,-77,-162,FLAT
6,48,108,156,94,73,166,189,38,102,40,6,-14,90,7,44,-141,-55,-45,-8,-162,-73,-40,-135,FLAT
-11,39,31,70,156,94,73,166,6,-88,-2,-11,44,14,38,-5,-8,2,5,33,-135,-143,-47,-19,FLAT
56,61,47,108,70,156,94,73,-11,72,34,56,-5,-16,32,45,33,86,72,51,-19,74,39,89,FLAT
0,2,52,54,108,70,156,94,56,5,59,0,45,77,93,56,51,-11,91,45,89,91,131,51,FLAT
-35,19,77,96,54,108,70,156,0,-10,-52,-35,56,-5,7,-35,45,67,41,21,51,-21,39,10,FLAT
44,80,25,105,96,54,108,70,-35,-8,-17,44,-35,-18,-69,9,21,-13,-10,9,10,59,24,65,FLAT
-30,13,33,46,105,96,54,108,44,-22,37,-30,9,-30,20,14,9,-40,-32,-21,65,-35,27,-21,FLAT
-48,40,58,98,46,105,96,54,-30,-23,-75,-48,14,-45,-38,-78,-21,-53,-55,-34,-21,-63,-107,-69,FLAT
130,163,75,238,98,46,105,96,-48,147,7,130,-78,124,-68,82,-34,102,-31,52,-69,94,-48,96,FLAT
-82,6,87,93,238,98,46,105,130,-70,75,-82,82,77,82,48,52,54,7,0,96,32,44,-30,FLAT
-22,12,46,58,93,238,98,46,-82,-63,-28,-22,48,-133,47,-104,0,14,54,26,-30,-9,-21,-22,FLAT
60,85,12,97,58,93,238,98,-22,26,-13,60,-104,-37,-41,38,26,-107,34,-44,-22,40,41,86,FLAT
-52,50,52,102,124,152,29,41,-2,-68,-46,-52,-27,-54,-4,-54,-12,-38,-111,-79,3,-18,-79,-64,FLAT
-97,7,120,127,102,124,152,29,-52,-29,-54,-97,-54,-97,-100,-149,-79,-83,-58,-151,-64,-67,-165,-176,FLAT
-64,7,70,77,127,102,124,152,-97,-114,-64,-64,-149,-143,-118,-161,-151,-211,-164,-213,-176,-197,-122,-215,FLAT
64,71,16,87,77,127,102,124,-64,10,0,64,-161,-104,-64,0,-213,-133,-118,-97,-215,-201,-164,-149,FLAT
59,64,3,67,87,77,127,102,64,46,66,59,0,56,66,123,-97,-58,2,59,-149,-87,-52,-38,FLAT
-17,22,42,64,67,87,77,127,59,22,25,-17,123,68,91,42,59,78,91,106,-38,-36,27,42,FLAT
-17,17,28,45,64,67,87,77,-17,-31,-12,-17,42,-9,13,-34,106,37,79,25,42,47,79,89,FLAT
-34,173,45,218,45,64,67,87,-17,-17,-190,-34,-34,-48,-202,-51,25,-26,-177,-68,89,20,-111,-9,FLAT
202,210,5,215,218,45,64,67,-34,162,165,202,-51,145,-25,168,-68,114,-37,151,-9,136,-12,134,FLAT
-50,45,50,95,215,218,45,64,202,-5,115,-50,168,157,280,152,151,140,90,118,134,109,78,101,FLAT
5,34,48,82,95,215,218,45,-50,3,16,5,152,-2,131,-45,118,160,296,157,101,143,106,123,FLAT
-39,8,84,92,82,95,215,218,5,-3,-13,-39,-45,0,3,-34,157,-5,118,-84,123,157,283,118,FLAT
-66,26,203,229,92,82,95,215,-39,53,-84,-66,-34,50,-97,-105,-84,53,-81,-100,118,48,34,-150,FLAT
20,124,154,278,229,92,82,95,-66,-29,-78,20,-105,24,-162,-46,-100,21,-175,-85,-150,24,-159,-80,FLAT
-158,19,197,216,278,229,92,82,20,-115,-53,-158,-46,-144,-131,-138,-85,-91,-215,-204,-80,-94,-228,-243,FLAT
29,73,30,103,216,278,229,92,-158,-138,-25,29,-138,-253,-78,-129,-204,-282,-156,-109,-243,-229,-240,-175,FLAT
-86,80,91,171,103,216,278,229,29,-25,-93,-86,-129,-163,-118,-57,-109,-278,-171,-215,-175,-307,-249,-195,FLAT
-4,37,61,98,171,103,216,278,-86,-34,39,-4,-57,-59,-54,-90,-215,-197,-79,-61,-195,-312,-132,-219,FLAT
-46,18,56,74,151,94,98,171,99,-35,42,-46,130,63,83,53,126,79,103,84,40,45,142,80,FLAT
46,77,0,77,74,151,94,98,-46,-10,-13,46,53,-45,29,0,84,53,70,99,80,69,90,130,FLAT
-20,14,48,62,77,74,151,94,46,28,43,-20,0,18,30,26,99,-17,72,-20,130,81,113,79,FLAT
90,102,27,129,62,77,74,151,-20,69,2,90,26,97,45,70,-20,87,32,116,79,52,74,70,FLAT
24,41,35,76,129,62,77,74,90,32,85,24,70,101,87,114,116,129,130,94,70,119,117,140,FLAT
13,45,7,52,76,129,62,77,24,-15,9,13,114,17,94,37,94,86,96,127,140,114,139,107,FLAT
113,115,23,138,52,76,129,62,13,129,43,113,37,114,52,126,127,146,137,150,107,215,139,240,FLAT
80,123,5,128,138,52,76,129,113,62,72,80,126,191,115,193,150,176,124,206,240,208,209,230,FLAT
-7,13,32,45,128,138,52,76,80,20,103,-7,193,82,175,73,206,211,218,186,230,196,227,199,FLAT
146,161,23,184,45,128,138,52,-7,137,-2,146,73,157,101,139,186,219,173,219,199,348,216,332,FLAT
96,112,0,112,184,45,128,138,146,73,145,96,139,210,143,242,219,230,246,235,332,292,318,315,FLAT
-79,8,84,92,112,184,45,128,96,5,25,-79,242,78,170,17,235,215,168,163,315,235,271,156,FLAT
-6,12,45,57,92,112,184,45,-79,-45,-10,-6,17,-40,15,-85,163,33,160,11,156,170,158,157,FLAT
16,25,76,101,57,92,112,184,-6,47,3,16,-85,2,-7,10,11,7,18,-69,157,80,163,27,FLAT
39,78,39,117,101,57,92,112,16,2,-14,39,10,49,-11,55,-69,4,-21,49,27,9,4,-30,FLAT
-86,21,278,299,117,101,57,92,39,153,-29,-86,55,155,-43,-47,49,202,-40,-31,-30,157,-50,-37,FLAT
32,61,62,123,299,117,101,57,-86,-184,-8,32,-47,-31,-37,-54,-31,-29,-51,-15,-37,18,-48,1,FLAT
-104,58,104,162,123,299,117,101,32,-62,-101,-104,-54,-246,-109,-72,-15,-93,-138,-158,1,-91,-152,-119,FLAT
10,68,25,93,162,123,299,117,-104,-69,0,10,-72,-131,-101,-94,-158,-315,-109,-62,-119,-162,-138,-148,FLAT
-24,44,47,91,93,162,123,299,10,-2,0,-24,-94,-71,0,-14,-62,-133,-101,-118,-148,-317,-109,-86,FLAT
178,182,36,218,222,91,93,162,199,208,212,178,175,366,239,377,185,364,239,353,81,295,239,363,FLAT
26,35,97,132,218,222,91,93,178,87,173,26,377,295,385,204,353,453,412,403,363,451,412,379,FLAT
-50,61,56,117,76,69,132,218,-26,-21,-62,-50,-23,-76,-124,-76,3,-114,-99,-73,181,-27,74,-47,FLAT
2,86,22,108,117,76,69,132,-50,-32,-23,2,-76,-53,-85,-48,-73,-108,-147,-74,-47,-146,-122,-71,FLAT
-7,36,29,65,108,117,76,69,2,0,43,-7,-48,-32,20,-5,-74,-53,-42,-55,-71,-108,-104,-81,FLAT
83,83,16,99,65,108,117,76,-7,70,36,83,-5,70,79,76,-55,38,56,78,-81,17,-6,28,FLAT
-26,1,73,74,99,65,108,117,83,31,56,-26,76,101,92,57,78,101,135,50,28,69,112,52,FLAT
-30,10,50,60,74,99,65,108,-26,-53,-39,-30,57,-22,17,-56,50,48,53,27,52,48,96,20,FLAT
-35,9,57,66,60,74,99,65,-30,-28,-34,-35,-56,-81,-73,-65,27,-50,-17,-91,20,20,19,-8,FLAT
-38,4,54,58,66,60,74,99,-35,-41,-33,-38,-65,-69,-67,-73,-91,-122,-106,-103,-8,-91,-50,-129,FLAT
28,38,9,47,58,66,60,74,-38,-17,-6,28,-73,-58,-39,-10,-103,-86,-73,-45,-129,-139,-112,-75,FLAT
-90,12,93,105,47,58,66,60,28,-6,-64,-90,-10,-23,-70,-62,-45,-64,-103,-100,-75,-92,-137,-135,FLAT
-25,6,52,58,105,47,58,66,-90,-66,-19,-25,-62,-72,-83,-115,-100,-89,-89,-87,-135,-130,-122,-125,FLAT
45,61,30,91,58,105,47,58,-25,23,-10,45,-115,-43,-29,20,-87,-49,-93,-70,-125,-66,-99,-42,FLAT
-10,4,24,28,40,30,29,34,-31,-23,-11,-10,-22,-33,-31,-41,-19,-21,-20,-32,1,-6,0,-29,FLAT
-12,11,13,24,28,40,30,29,-10,-23,-19,-12,-41,-46,-30,-22,-32,-56,-50,-53,-29,-44,-39,-44,FLAT
-15,5,25,30,24,28,40,30,-12,-3,-9,-15,-22,-26,-28,-27,-53,-49,-39,-37,-44,-59,-59,-68,FLAT
5,13,14,27,30,24,28,40,-15,-6,-3,5,-27,-9,-12,-10,-37,-32,-31,-22,-68,-55,-42,-32,FLAT
-44,3,51,54,27,30,24,28,5,-7,-34,-44,-10,-13,-37,-39,-22,-16,-46,-54,-32,-39,-65,-66,FLAT
46,52,0,52,54,27,30,24,-44,-5,-3,46,-39,-12,-37,2,-54,-18,-40,7,-66,-21,-49,-8,FLAT
-32,2,35,37,52,54,27,30,46,3,18,-32,2,-2,15,14,7,-9,-19,-30,-8,-15,-22,-25,FLAT
-11,0,37,37,37,52,54,27,-32,-9,-9,-11,14,-6,9,-43,-30,-11,6,3,-25,-18,-28,-41,FLAT
-10,45,11,56,86,37,37,52,82,0,30,-10,71,46,27,72,39,37,18,61,85,40,36,29,FLAT
-28,9,72,81,56,86,37,37,-10,33,8,-28,72,33,38,-38,61,79,35,44,29,70,26,33,FLAT
-1,11,44,55,81,56,86,37,-28,-29,-3,-1,-38,4,5,-29,44,4,35,-39,33,50,32,43,FLAT
5,43,37,80,55,81,56,86,-1,-2,-27,5,-29,-31,-30,4,-39,2,-22,-24,43,2,8,-34,FLAT
21,22,59,81,80,55,81,56,5,43,42,21,4,41,15,26,-24,12,12,25,-34,45,20,-3,FLAT
125,127,10,137,81,80,55,81,21,76,20,125,26,119,62,146,25,117,35,151,-3,88,32,150,FLAT
-62,1,97,98,137,81,80,55,125,25,64,-62,146,101,84,63,151,144,126,84,150,142,99,89,FLAT
4,23,16,39,98,137,81,80,-62,-77,-18,4,63,-52,46,-58,84,24,66,67,89,67,108,88,FLAT
21,59,6,65,39,98,137,81,4,11,-15,21,-58,-66,-33,25,67,-41,31,-37,88,35,51,88,FLAT
-30,29,51,80,65,39,98,137,21,15,0,-30,25,26,-15,-9,-37,-51,-33,-5,88,-26,31,-67,FLAT
-40,33,47,80,80,65,39,98,-30,-44,-44,-40,-9,-29,-44,-70,-5,-18,-59,-49,-67,-95,-77,-45,FLAT
191,192,22,214,80,80,65,39,-40,166,32,191,-70,122,-12,151,-49,137,-12,121,-45,148,-27,142,FLAT
-22,60,44,104,214,80,80,65,191,0,110,-22,151,166,142,169,121,122,98,129,142,137,98,99,FLAT
-35,17,35,52,104,214,80,80,-22,-44,8,-35,169,-44,118,-57,129,122,150,134,99,78,106,94,FLAT
72,84,22,106,52,104,214,80,-35,59,5,72,-57,15,13,37,134,15,123,15,94,181,155,206,FLAT
-29,34,30,64,106,52,104,214,72,-21,21,-29,37,38,26,43,15,-6,34,8,206,-6,144,-14,FLAT
40,74,2,76,64,106,52,104,-29,12,0,40,43,-9,21,11,8,50,26,83,-14,6,34,48,FLAT
10,46,21,67,76,64,106,52,40,29,38,10,11,41,38,50,83,20,59,21,48,79,64,93,FLAT
2,36,8,44,67,76,64,106,10,-11,12,2,50,18,50,12,21,30,50,52,93,9,71,23,FLAT
-23,26,23,49,53,55,44,67,-31,-31,-27,-23,-42,-67,-61,-54,-40,-50,-55,-65,-30,-61,-43,-63,FLAT
-67,6,74,80,49,53,55,44,-23,-16,-47,-67,-54,-47,-74,-90,-65,-83,-108,-121,-63,-66,-102,-132,FLAT
22,37,28,65,80,49,53,55,-67,-24,-9,22,-90,-40,-56,-45,-121,-71,-83,-68,-132,-107,-117,-99,FLAT
-58,8,121,129,65,80,49,53,22,35,-29,-58,-45,11,-38,-36,-68,-5,-85,-103,-99,-36,-112,-126,FLAT
55,76,3,79,129,65,80,49,-58,-63,-13,55,-36,-28,-42,-3,-103,-52,-51,19,-126,-68,-98,-48,FLAT
43,43,20,63,79,129,65,80,55,60,76,43,-3,-3,63,98,19,32,34,40,-48,8,25,62,FLAT
-25,0,105,105,63,79,129,65,43,60,18,-25,98,120,94,18,40,57,81,73,62,92,52,15,FLAT
-53,8,57,65,105,63,79,129,-25,-101,-61,-53,18,-41,-43,-78,73,19,33,-35,15,-44,20,20,FLAT
-3,81,3,84,65,105,63,79,-53,-57,-76,-3,-78,-158,-137,-56,-35,-98,-119,-81,20,-38,-43,-38,FLAT
137,140,9,149,84,65,105,63,-3,143,78,137,-56,86,2,134,-81,-15,-59,81,-38,45,-41,56,FLAT
11,26,81,107,149,84,65,105,137,83,125,11,134,226,203,148,81,169,127,145,56,68,66,92,FLAT
49,54,35,89,107,149,84,65,11,3,21,49,148,86,146,60,145,229,224,197,92,172,148,194,FLAT
-68,15,131,146,82,89,107,149,-37,-4,-68,-68,12,-9,-66,-105,23,-6,-45,-56,160,77,80,-45,FLAT
-67,30,75,105,146,82,89,107,-68,-123,-82,-67,-105,-127,-150,-135,-56,-132,-148,-172,-45,-129,-127,-123,FLAT
-53,11,69,80,105,146,82,89,-67,-59,-34,-53,-135,-182,-116,-120,-172,-186,-184,-188,-123,-191,-182,-225,FLAT
64,140,1,141,80,105,146,82,-53,-4,-65,64,-120,-63,-99,11,-188,-186,-181,-56,-225,-190,-249,-124,FLAT
-37,22,71,93,141,80,105,146,64,33,81,-37,11,29,16,27,-56,-30,-18,-26,-124,-153,-100,-93,FLAT
-42,4,60,64,93,141,80,105,-37,-53,-24,-42,27,-20,57,-79,-26,-24,-8,-15,-93,-83,-42,-68,FLAT
-44,29,64,93,64,93,141,80,-42,-40,-69,-44,-79,-93,-93,-86,-15,-60,-12,-123,-68,-64,-77,-59,FLAT
-22,7,37,44,93,64,93,141,-44,-49,0,-22,-86,-89,-69,-66,-123,-142,-93,-108,-59,-109,-12,-145,FLAT
-58,14,72,86,44,93,64,93,-22,-23,-65,-58,-66,-72,-65,-80,-108,-112,-134,-124,-145,-165,-158,-166,FLAT
10,32,17,49,86,44,93,64,-58,-45,-8,10,-80,-68,-73,-48,-124,-117,-73,-70,-166,-157,-142,-114,FLAT
-19,4,23,27,49,86,44,93,10,-13,9,-19,-48,-58,1,-9,-70,-81,-64,-67,-114,-130,-64,-89,FLAT
38,40,25,65,27,49,86,44,-19,40,2,38,-9,27,11,19,-67,-18,3,29,-89,-41,-62,-29,FLAT
-5,11,24,35,65,27,49,86,38,-6,24,-5,19,34,26,33,29,21,35,14,-29,-24,27,24,FLAT
-37,6,48,54,35,65,27,49,-5,-13,-32,-37,33,-19,-8,-42,14,21,-6,-4,24,8,3,-23,FLAT